AAAAAGGCGGC -> AAAAGGCGGCC
AAAACATTTCG -> AAACATTTCGG
AAAACCCAGGA -> AAACCCAGGAT
AAAACCCCGTC -> AAACCCCGTCG
AAAACGACGGC -> AAACGACGGCC
AAAACGCTAGC -> AAACGCTAGCA
AAAAGGCGGCC -> AAAGGCGGCCC
AAAAGTATGCA -> AAAGTATGCAT
AAAATCGGGTA -> AAATCGGGTAC
AAAATTGGGTA -> AAATTGGGTAG
AAACACCTAGC -> AACACCTAGCC
AAACAGTATAG -> AACAGTATAGT
AAACATTTCGG -> AACATTTCGGC
AAACCCAGGAT -> AACCCAGGATC
AAACCCCGTCG -> AACCCCGTCGG
AAACCCCTAAC -> AACCCCTAACG
AAACGACGGCC -> AACGACGGCCG
AAACGCTAGCA -> AACGCTAGCAT
AAACGGCTAGG -> AACGGCTAGGC
AAACGTCAAGT -> AACGTCAAGTG
AAACTACGTCG -> AACTACGTCGA
AAAGAAGGCTT -> AAGAAGGCTTA
AAAGACAATAT -> AAGACAATATT
AAAGAGCAGGG -> AAGAGCAGGGA
AAAGCGTAATA -> AAGCGTAATAG
AAAGGACTCAA -> AAGGACTCAAC
AAAGGCAGGAC -> AAGGCAGGACG
AAAGGCGGCCC -> AAGGCGGCCCT
AAAGTATGCAT -> AAGTATGCATA
AAAGTCCCTGT -> AAGTCCCTGTA
AAATACTCGTT -> AATACTCGTTG
AAATCGGGTAC -> AATCGGGTACA
AAATTAAAACA -> AATTAAAACAT
AAATTGGGTAG -> AATTGGGTAGA
AACACCATGAG -> ACACCATGAGA
AACACCGTCAC -> ACACCGTCACA
AACACCTAGCC -> ACACCTAGCCA
AACACTGGATC -> ACACTGGATCA
AACAGTACGCG -> ACAGTACGCGA
AACAGTATAGT -> ACAGTATAGTT
AACATGAGAGC -> ACATGAGAGCT
AACATTACCGG -> ACATTACCGGG
AACATTTCGGC -> ACATTTCGGCT
AACCATGGTCT -> ACCATGGTCTT
AACCATTGATA -> ACCATTGATAT
AACCCAGGATC -> ACCCAGGATCT
AACCCAGTCGG -> ACCCAGTCGGA
AACCCCGTCGG -> ACCCCGTCGGC
AACCCCTAACG -> ACCCCTAACGG
AACCCTCGCTA -> ACCCTCGCTAC
AACCTCAAAAC -> ACCTCAAAACG
AACCTCAAGGG -> ACCTCAAGGGA
AACGACGGCCG -> ACGACGGCCGG
AACGCTAGCAT -> ACGCTAGCATA
AACGGACCGTG -> ACGGACCGTGT
AACGGCGCGCA -> ACGGCGCGCAC
AACGGCGGTAC -> ACGGCGGTACG
AACGGCTAGGC -> ACGGCTAGGCG
AACGGTGGTCA -> ACGGTGGTCAT
AACGTAGTTGG -> ACGTAGTTGGG
AACGTCAAGTG -> ACGTCAAGTGG
AACGTGCTCGT -> ACGTGCTCGTA
AACTACGTCGA -> ACTACGTCGAC
AACTCCGACCG -> ACTCCGACCGG
AACTCCTCCTT -> ACTCCTCCTTG
AACTGGGGAGG -> ACTGGGGAGGG
AACTTCAATAT -> ACTTCAATATT
AAGAAGGCTTA -> AGAAGGCTTAT
AAGAAGTACTC -> AGAAGTACTCT
AAGACAATATT -> AGACAATATTA
AAGAGACTGTT -> AGAGACTGTTT
AAGAGCAGGGA -> AGAGCAGGGAC
AAGATTTAAAC -> AGATTTAAACA
AAGCAAGGCCG -> AGCAAGGCCGT
AAGCAGATCAC -> AGCAGATCACT
AAGCAGCTGCG -> AGCAGCTGCGC
AAGCATGAGAA -> AGCATGAGAAT
AAGCCCGACGG -> AGCCCGACGGA
AAGCCGCTTCA -> AGCCGCTTCAA
AAGCGTAATAG -> AGCGTAATAGG
AAGCTACTCGA -> AGCTACTCGAG
AAGCTGCATTT -> AGCTGCATTTG
AAGCTTTACTG -> AGCTTTACTGC
AAGGACTCAAC -> AGGACTCAACG
AAGGATTATTT -> AGGATTATTTG
AAGGCAGGACG -> AGGCAGGACGT
AAGGCCGTGTG -> AGGCCGTGTGA
AAGGCGGCCCT -> AGGCGGCCCTG
AAGGCTTATCC -> AGGCTTATCCC
AAGGGACCGTC -> AGGGACCGTCA
AAGGGGACCTA -> AGGGGACCTAG
AAGGTGCTTTT -> AGGTGCTTTTA
AAGTAAACGGC -> AGTAAACGGCT
AAGTACTCTAA -> AGTACTCTAAT
AAGTATGCATA -> AGTATGCATAG
AAGTCCCTGTA -> AGTCCCTGTAC
AAGTCTTATTA -> AGTCTTATTAC
AAGTGCGAAGC -> AGTGCGAAGCC
AAGTGGTATGA -> AGTGGTATGAA
AAGTTCAAAGG -> AGTTCAAAGGC
AATAAGCAGAT -> ATAAGCAGATC
AATAAGGGGAC -> ATAAGGGGACC
AATAATTAGAG -> ATAATTAGAGG
AATACCACGCC -> ATACCACGCCG
AATACTCAACA -> ATACTCAACAG
AATACTCGTTG -> ATACTCGTTGC
AATAGGTTACT -> ATAGGTTACTT
AATATACATCC -> ATATACATCCC
AATATTAACAC -> ATATTAACACT
AATATTACAGG -> ATATTACAGGA
AATATTGTGAA -> ATATTGTGAAA
AATCATCGGGT -> ATCATCGGGTA
AATCCACGCTA -> ATCCACGCTAG
AATCGGGTACA -> ATCGGGTACAC
AATCTAACACC -> ATCTAACACCG
AATGGCCTGGA -> ATGGCCTGGAA
AATGTGCATCC -> ATGTGCATCCG
AATTAAAACAT -> ATTAAAACATT
AATTAAGGTGC -> ATTAAGGTGCT
AATTACCTACA -> ATTACCTACAT
AATTAGAGGGC -> ATTAGAGGGCG
AATTATCGTCC -> ATTATCGTCCA
AATTCAACATT -> ATTCAACATTA
AATTCAGCACT -> ATTCAGCACTA
AATTCGCTCCT -> ATTCGCTCCTT
AATTCTAGTCC -> ATTCTAGTCCA
AATTGGGTAGA -> ATTGGGTAGAG
ACAAACGTCAA -> CAAACGTCAAG
ACAAACTACGT -> CAAACTACGTC
ACAAAGAGCAG -> CAAAGAGCAGG
ACAAAGTCCCT -> CAAAGTCCCTG
ACAATATTAAC -> CAATATTAACA
ACAATATTACA -> CAATATTACAG
ACAATCCACGC -> CAATCCACGCT
ACAATTCAGCA -> CAATTCAGCAC
ACACATGCCAG -> CACATGCCAGA
ACACCATGAGA -> CACCATGAGAC
ACACCGCCTGC -> CACCGCCTGCT
ACACCGTCACA -> CACCGTCACAC
ACACCTAGCCA -> CACCTAGCCAA
ACACTAAGTAA -> CACTAAGTAAA
ACACTGGATCA -> CACTGGATCAT
ACACTGTCAAC -> CACTGTCAACG
ACACTTAGCCA -> CACTTAGCCAG
ACAGACGGATT -> CAGACGGATTG
ACAGAGGGCGC -> CAGAGGGCGCC
ACAGGACTTCG -> CAGGACTTCGG
ACAGGAGGTTT -> CAGGAGGTTTT
ACAGGTCATGC -> CAGGTCATGCT
ACAGTACGCGA -> CAGTACGCGAT
ACAGTATAGTT -> CAGTATAGTTC
ACATCCCGGTG -> CATCCCGGTGA
ACATGAATTCA -> CATGAATTCAA
ACATGAGAGCT -> CATGAGAGCTC
ACATGATTAAC -> CATGATTAACA
ACATGCCAGAA -> CATGCCAGAAA
ACATGCTACAT -> CATGCTACATG
ACATGGCTCCT -> CATGGCTCCTA
ACATTACCGGG -> CATTACCGGGC
ACATTCTCGGA -> CATTCTCGGAT
ACATTTCGGCT -> CATTTCGGCTG
ACCAATCTAAC -> CCAATCTAACA
ACCAATTCTAG -> CCAATTCTAGT
ACCACAAACTA -> CCACAAACTAC
ACCACGCCGGT -> CCACGCCGGTC
ACCAGATGCCG -> CCAGATGCCGA
ACCAGGGTTTG -> CCAGGGTTTGT
ACCATACTTTT -> CCATACTTTTA
ACCATGAGACA -> CCATGAGACAA
ACCATGGTCTT -> CCATGGTCTTC
ACCATGTGGTT -> CCATGTGGTTG
ACCATTGATAT -> CCATTGATATT
ACCCAAGCTGC -> CCCAAGCTGCA
ACCCACAAACG -> CCCACAAACGT
ACCCAGGATCT -> CCCAGGATCTA
ACCCAGTCGGA -> CCCAGTCGGAT
ACCCCGTCGGC -> CCCCGTCGGCT
ACCCCTAACGG -> CCCCTAACGGA
ACCCCTAGCGT -> CCCCTAGCGTT
ACCCCTCACTA -> CCCCTCACTAG
ACCCGACTTAG -> CCCGACTTAGC
ACCCGAGTTCT -> CCCGAGTTCTA
ACCCGCTCTCA -> CCCGCTCTCAC
ACCCTCGCTAC -> CCCTCGCTACC
ACCGACAGGAC -> CCGACAGGACT
ACCGCAGCATC -> CCGCAGCATCA
ACCGCCGCATT -> CCGCCGCATTA
ACCGCCTCGAC -> CCGCCTCGACC
ACCGCCTGCTA -> CCGCCTGCTAT
ACCGGACAATT -> CCGGACAATTC
ACCGGCGAGGC -> CCGGCGAGGCG
ACCGGGCGAAA -> CCGGGCGAAAC
ACCGTCAAGCA -> CCGTCAAGCAG
ACCGTCACACC -> CCGTCACACCG
ACCGTCACTGT -> CCGTCACTGTA
ACCGTGTTGGT -> CCGTGTTGGTT
ACCTACATGCT -> CCTACATGCTA
ACCTACGTTGC -> CCTACGTTGCC
ACCTAGCCAAC -> CCTAGCCAACA
ACCTAGGCATT -> CCTAGGCATTG
ACCTCAAAACG -> CCTCAAAACGC
ACCTCAAGGGA -> CCTCAAGGGAC
ACCTGTCAGAT -> CCTGTCAGATT
ACGACGGCCGG -> CGACGGCCGGC
ACGAGGCTAAG -> CGAGGCTAAGA
ACGAGTCACCG -> CGAGTCACCGT
ACGCATAGACC -> CGCATAGACCA
ACGCCAAGTTC -> CGCCAAGTTCA
ACGCCGGTCTA -> CGCCGGTCTAA
ACGCGATCTTT -> CGCGATCTTTA
ACGCTAGCATA -> CGCTAGCATAG
ACGCTAGTGGT -> CGCTAGTGGTC
ACGGACCGTGT -> CGGACCGTGTT
ACGGAGTTACC -> CGGAGTTACCG
ACGGATACAAA -> CGGATACAAAG
ACGGATTGATA -> CGGATTGATAG
ACGGCCGGCTC -> CGGCCGGCTCA
ACGGCGCGCAC -> CGGCGCGCACT
ACGGCGGTACG -> CGGCGGTACGC
ACGGCTAGGCG -> CGGCTAGGCGG
ACGGGCTTTAG -> CGGGCTTTAGC
ACGGTGGTCAT -> CGGTGGTCATG
ACGGTGTAGGC -> CGGTGTAGGCC
ACGTAACCTCA -> CGTAACCTCAA
ACGTAGTTGGG -> CGTAGTTGGGC
ACGTCAAGTGG -> CGTCAAGTGGT
ACGTCATTTTA -> CGTCATTTTAA
ACGTCGACGAG -> CGTCGACGAGT
ACGTCGCGTCC -> CGTCGCGTCCA
ACGTCGGGCAA -> CGTCGGGCAAA
ACGTGCTCGTA -> CGTGCTCGTAA
ACGTGTCCACC -> CGTGTCCACCA
ACGTTGCCCTT -> CGTTGCCCTTA
ACTAAAATCGG -> CTAAAATCGGG
ACTAAAATTGG -> CTAAAATTGGG
ACTAAGTAAAC -> CTAAGTAAACG
ACTAATTACCT -> CTAATTACCTA
ACTACGTCGAC -> CTACGTCGACG
ACTACGTCGGG -> CTACGTCGGGC
ACTAGAATAAG -> CTAGAATAAGG
ACTAGAATAAT -> CTAGAATAATT
ACTAGGCAATC -> CTAGGCAATCA
ACTCAACAGTA -> CTCAACAGTAC
ACTCAACGGTG -> CTCAACGGTGG
ACTCCGACCGG -> CTCCGACCGGA
ACTCCTCCTTG -> CTCCTCCTTGG
ACTCGAGACCA -> CTCGAGACCAC
ACTCGTTGCTG -> CTCGTTGCTGT
ACTCTAATACT -> CTCTAATACTC
ACTGCATTTGT -> CTGCATTTGTC
ACTGGATCATT -> CTGGATCATTG
ACTGGGGAGGG -> CTGGGGAGGGA
ACTGTACACTT -> CTGTACACTTA
ACTGTCAACGG -> CTGTCAACGGC
ACTGTCTGCCC -> CTGTCTGCCCG
ACTGTGATCGT -> CTGTGATCGTC
ACTGTTTAGCC -> CTGTTTAGCCA
ACTTAGCCAGA -> CTTAGCCAGAC
ACTTAGCTACT -> CTTAGCTACTA
ACTTATCCCCT -> CTTATCCCCTA
ACTTCAATATT -> CTTCAATATTG
ACTTCGGGCCT -> CTTCGGGCCTC
ACTTGAGGACC -> CTTGAGGACCC
ACTTGGTAAAG -> CTTGGTAAAGG
ACTTTGACCAG -> CTTTGACCAGA
ACTTTTAGAGA -> CTTTTAGAGAT
AGAAAACGACG -> GAAAACGACGG
AGAACGGCGCG -> GAACGGCGCGC
AGAAGAAGTAC -> GAAGAAGTACT
AGAAGCAAGGC -> GAAGCAAGGCC
AGAAGGCTTAT -> GAAGGCTTATC
AGAAGTACTCT -> GAAGTACTCTA
AGAATAAGCAG -> GAATAAGCAGA
AGAATAAGGGG -> GAATAAGGGGA
AGAATAATTAG -> GAATAATTAGA
AGACAATATTA -> GACAATATTAC
AGACAATCCAC -> GACAATCCACG
AGACCACAAAC -> GACCACAAACT
AGACCATGTGG -> GACCATGTGGT
AGACCCGCTCT -> GACCCGCTCTC
AGACGGATTGA -> GACGGATTGAT
AGACGTCGCGT -> GACGTCGCGTC
AGACTGTTTAG -> GACTGTTTAGC
AGAGACTGTTT -> GAGACTGTTTA
AGAGATTACAA -> GAGATTACAAA
AGAGCAGGGAC -> GAGCAGGGACC
AGAGCTCAGAA -> GAGCTCAGAAG
AGAGGGCGCCA -> GAGGGCGCCAG
AGAGGGCGGTC -> GAGGGCGGTCT
AGAGTGTTTCA -> GAGTGTTTCAC
AGATCACTGTC -> GATCACTGTCT
AGATGCCGATG -> GATGCCGATGA
AGATTACAAAG -> GATTACAAAGT
AGATTCGGAAC -> GATTCGGAACC
AGATTTAAACA -> GATTTAAACAG
AGCAAGGCCGT -> GCAAGGCCGTG
AGCACGGATAC -> GCACGGATACA
AGCACTAATTA -> GCACTAATTAC
AGCAGATCACT -> GCAGATCACTG
AGCAGCTGCGC -> GCAGCTGCGCT
AGCAGGGACCC -> GCAGGGACCCC
AGCATAGTGGC -> GCATAGTGGCG
AGCATCATACG -> GCATCATACGC
AGCATGAGAAT -> GCATGAGAATA
AGCCAACATGA -> GCCAACATGAG
AGCCACATGAT -> GCCACATGATT
AGCCAGACCCG -> GCCAGACCCGC
AGCCCGACGGA -> GCCCGACGGAG
AGCCGCTTCAA -> GCCGCTTCAAC
AGCCTACCATA -> GCCTACCATAC
AGCGCCTATGG -> GCGCCTATGGC
AGCGCTTGCTC -> GCGCTTGCTCC
AGCGTAATAGG -> GCGTAATAGGT
AGCGTTTTTCC -> GCGTTTTTCCT
AGCTACTAGGC -> GCTACTAGGCA
AGCTACTCGAG -> GCTACTCGAGA
AGCTCAGAAGC -> GCTCAGAAGCA
AGCTGCATTTG -> GCTGCATTTGG
AGCTGCGCTGA -> GCTGCGCTGAC
AGCTTCCATCG -> GCTTCCATCGA
AGCTTTACTGC -> GCTTTACTGCA
AGGACATTCTC -> GGACATTCTCG
AGGACCAATCT -> GGACCAATCTA
AGGACCCAAGC -> GGACCCAAGCT
AGGACCCACAA -> GGACCCACAAA
AGGACGTCATT -> GGACGTCATTT
AGGACTCAACG -> GGACTCAACGG
AGGACTTCGGG -> GGACTTCGGGC
AGGAGGTTTTC -> GGAGGTTTTCC
AGGATCTACTG -> GGATCTACTGT
AGGATTATTTG -> GGATTATTTGT
AGGCAAGGATT -> GGCAAGGATTA
AGGCAATCATC -> GGCAATCATCG
AGGCAGGACGT -> GGCAGGACGTC
AGGCATTGCTA -> GGCATTGCTAA
AGGCCGTGTGA -> GGCCGTGTGAG
AGGCCTTCCAT -> GGCCTTCCATT
AGGCGGCCAGC -> GGCGGCCAGCC
AGGCGGCCCTG -> GGCGGCCCTGC
AGGCGGCGAGG -> GGCGGCGAGGG
AGGCGGTGGGC -> GGCGGTGGGCC
AGGCGTGCACA -> GGCGTGCACAG
AGGCTAAGATT -> GGCTAAGATTT
AGGCTTATCCC -> GGCTTATCCCG
AGGGACAGGTC -> GGGACAGGTCA
AGGGACCCCTA -> GGGACCCCTAG
AGGGACCGTCA -> GGGACCGTCAC
AGGGCAAGCTT -> GGGCAAGCTTT
AGGGCAAGTCT -> GGGCAAGTCTT
AGGGCGCCAGC -> GGGCGCCAGCA
AGGGCGGTCTT -> GGGCGGTCTTT
AGGGGACCTAG -> GGGGACCTAGG
AGGGTAGGACC -> GGGTAGGACCC
AGGGTTTGTCT -> GGGTTTGTCTT
AGGTCATGCTC -> GGTCATGCTCG
AGGTGATGCTC -> GGTGATGCTCA
AGGTGCTTTTA -> GGTGCTTTTAA
AGGTTACTTTG -> GGTTACTTTGA
AGGTTGTCAGA -> GGTTGTCAGAC
AGGTTTGCAAT -> GGTTTGCAATT
AGGTTTTCCCT -> GGTTTTCCCTT
AGTAAACGGCT -> GTAAACGGCTA
AGTAACGTGCT -> GTAACGTGCTC
AGTACGCGATC -> GTACGCGATCT
AGTACTCTAAT -> GTACTCTAATA
AGTATAGTTCG -> GTATAGTTCGC
AGTATGCATAG -> GTATGCATAGA
AGTCACCGTCA -> GTCACCGTCAA
AGTCCAAAACC -> GTCCAAAACCC
AGTCCCTGTAC -> GTCCCTGTACA
AGTCGGATTTG -> GTCGGATTTGA
AGTCTTATTAC -> GTCTTATTACT
AGTGAAGAGAC -> GTGAAGAGACT
AGTGCGAAGCC -> GTGCGAAGCCC
AGTGCTCGGGG -> GTGCTCGGGGA
AGTGGCGCCCA -> GTGGCGCCCAA
AGTGGTATGAA -> GTGGTATGAAC
AGTGGTCCTAA -> GTGGTCCTAAA
AGTGTTTCACT -> GTGTTTCACTT
AGTTACCGACA -> GTTACCGACAG
AGTTATATAAA -> GTTATATAAAG
AGTTCAAAGGC -> GTTCAAAGGCA
AGTTCGCCTCT -> GTTCGCCTCTC
AGTTCTAGTGA -> GTTCTAGTGAA
AGTTGGGCGCC -> GTTGGGCGCCA
ATAAAGCGTAA -> TAAAGCGTAAT
ATAAGCAGATC -> TAAGCAGATCA
ATAAGCCGCTT -> TAAGCCGCTTC
ATAAGGGGACC -> TAAGGGGACCT
ATAATTAGAGG -> TAATTAGAGGG
ATACAAAGAGC -> TACAAAGAGCA
ATACATCCCGG -> TACATCCCGGT
ATACCACGCCG -> TACCACGCCGG
ATACCCGACTT -> TACCCGACTTA
ATACCTACGTT -> TACCTACGTTG
ATACGCATAGA -> TACGCATAGAC
ATACGGTGTAG -> TACGGTGTAGG
ATACTAAAATC -> TACTAAAATCG
ATACTCAACAG -> TACTCAACAGT
ATACTCGTTGC -> TACTCGTTGCT
ATACTTTTAGA -> TACTTTTAGAG
ATAGAAGAAGT -> TAGAAGAAGTA
ATAGACCATGT -> TAGACCATGTG
ATAGGCAAGGA -> TAGGCAAGGAT
ATAGGCGTGCA -> TAGGCGTGCAC
ATAGGTTACTT -> TAGGTTACTTT
ATAGTGCTCGG -> TAGTGCTCGGG
ATAGTGGCGCC -> TAGTGGCGCCC
ATAGTTCGCCT -> TAGTTCGCCTC
ATATAAAGCGT -> TATAAAGCGTA
ATATACATCCC -> TATACATCCCG
ATATACGGTGT -> TATACGGTGTA
ATATAGGCAAG -> TATAGGCAAGG
ATATAGGCGTG -> TATAGGCGTGC
ATATTAACACT -> TATTAACACTG
ATATTACAGGA -> TATTACAGGAG
ATATTGTGAAA -> TATTGTGAAAT
ATATTGTGACC -> TATTGTGACCC
ATATTTAGGAC -> TATTTAGGACA
ATCAATTCGCT -> TCAATTCGCTC
ATCACCTGTCA -> TCACCTGTCAG
ATCACTGTCTG -> TCACTGTCTGC
ATCAGTTATAT -> TCAGTTATATA
ATCATACGCAT -> TCATACGCATA
ATCATCGGGTA -> TCATCGGGTAC
ATCATTGCAAA -> TCATTGCAAAA
ATCCACGCTAG -> TCCACGCTAGT
ATCCCCTAACC -> TCCCCTAACCA
ATCCCGGTGAT -> TCCCGGTGATC
ATCCCGTGATA -> TCCCGTGATAA
ATCCGCCCTTT -> TCCGCCCTTTT
ATCGACACATG -> TCGACACATGC
ATCGATCACCT -> TCGATCACCTG
ATCGGATACTA -> TCGGATACTAA
ATCGGGTACAC -> TCGGGTACACT
ATCGGGTACCA -> TCGGGTACCAA
ATCGTCCACAG -> TCGTCCACAGA
ATCGTCCAGCG -> TCGTCCAGCGC
ATCGTGCTTTC -> TCGTGCTTTCA
ATCTAACACCG -> TCTAACACCGT
ATCTACTGTGA -> TCTACTGTGAT
ATCTCCATATA -> TCTCCATATAG
ATCTTTAAAGA -> TCTTTAAAGAC
ATGAACTGGGG -> TGAACTGGGGA
ATGAATTCAAC -> TGAATTCAACA
ATGACTTGGTA -> TGACTTGGTAA
ATGAGAATAAG -> TGAGAATAAGC
ATGAGACAATC -> TGAGACAATCC
ATGAGAGCTCA -> TGAGAGCTCAG
ATGATTAACAC -> TGATTAACACC
ATGCACCGCCT -> TGCACCGCCTC
ATGCATAGAAG -> TGCATAGAAGA
ATGCCAGAAAA -> TGCCAGAAAAC
ATGCCGATGAC -> TGCCGATGACT
ATGCTACATGA -> TGCTACATGAA
ATGCTCAACCA -> TGCTCAACCAT
ATGCTCGGCTG -> TGCTCGGCTGA
ATGCTTGTTTC -> TGCTTGTTTCC
ATGGCCGCAGG -> TGGCCGCAGGG
ATGGCCTGGAA -> TGGCCTGGAAA
ATGGCTCCTAT -> TGGCTCCTATA
ATGGGTCGCGG -> TGGGTCGCGGT
ATGGTCTTCAT -> TGGTCTTCATC
ATGTGCATCCG -> TGTGCATCCGC
ATGTGCCGTTG -> TGTGCCGTTGC
ATGTGGTTGGA -> TGTGGTTGGAT
ATGTGTGATGG -> TGTGTGATGGG
ATTAAAACATT -> TTAAAACATTT
ATTAACACCAT -> TTAACACCATG
ATTAACACTGG -> TTAACACTGGA
ATTAACTTCAA -> TTAACTTCAAT
ATTAAGGTGCT -> TTAAGGTGCTT
ATTACAAAGTC -> TTACAAAGTCC
ATTACAGGAGG -> TTACAGGAGGT
ATTACCGGGCG -> TTACCGGGCGA
ATTACCTACAT -> TTACCTACATG
ATTACTAGAAT -> TTACTAGAATA
ATTAGAGGGCG -> TTAGAGGGCGG
ATTATCGTCCA -> TTATCGTCCAG
ATTATTTGTAC -> TTATTTGTACG
ATTCAACATTA -> TTCAACATTAC
ATTCAGCACTA -> TTCAGCACTAA
ATTCGCTCCTT -> TTCGCTCCTTC
ATTCGGAACCC -> TTCGGAACCCA
ATTCTAGTCCA -> TTCTAGTCCAA
ATTCTCGGATC -> TTCTCGGATCA
ATTGATAGTGC -> TTGATAGTGCT
ATTGATATTTA -> TTGATATTTAG
ATTGCAAAAAG -> TTGCAAAAAGG
ATTGCTAAGCT -> TTGCTAAGCTA
ATTGGAATACC -> TTGGAATACCA
ATTGGGTAGAG -> TTGGGTAGAGT
ATTGTGAAATA -> TTGTGAAATAC
ATTGTGACCCG -> TTGTGACCCGA
ATTGTGTGTAG -> TTGTGTGTAGG
ATTTAAACAGT -> TTTAAACAGTA
ATTTAGGACAT -> TTTAGGACATT
ATTTCATCGGA -> TTTCATCGGAT
ATTTCGGCTGT -> TTTCGGCTGTA
ATTTGATCTCC -> TTTGATCTCCA
ATTTGCGCAAC -> TTTGCGCAACT
ATTTGCGGCGA -> TTTGCGGCGAA
ATTTGGCCCGT -> TTTGGCCCGTC
ATTTGTACGTG -> TTTGTACGTGT
ATTTGTCTCAT -> TTTGTCTCATG
ATTTTAATGTG -> TTTTAATGTGC
CAAAAAGGCGG -> AAAAAGGCGGC
CAAAACCCAGG -> AAAACCCAGGA
CAAAACGCTAG -> AAAACGCTAGC
CAAACGTCAAG -> AAACGTCAAGT
CAAACTACGTC -> AAACTACGTCG
CAAAGAAGGCT -> AAAGAAGGCTT
CAAAGAGCAGG -> AAAGAGCAGGG
CAAAGGCAGGA -> AAAGGCAGGAC
CAAAGTCCCTG -> AAAGTCCCTGT
CAACAGTACGC -> AACAGTACGCG
CAACATGAGAG -> AACATGAGAGC
CAACATTACCG -> AACATTACCGG
CAACCATTGAT -> AACCATTGATA
CAACGGCGGTA -> AACGGCGGTAC
CAACGGTGGTC -> AACGGTGGTCA
CAACGTAGTTG -> AACGTAGTTGG
CAACTCCTCCT -> AACTCCTCCTT
CAAGCAGCTGC -> AAGCAGCTGCG
CAAGCATGAGA -> AAGCATGAGAA
CAAGCTGCATT -> AAGCTGCATTT
CAAGCTTTACT -> AAGCTTTACTG
CAAGGATTATT -> AAGGATTATTT
CAAGGCCGTGT -> AAGGCCGTGTG
CAAGGGACCGT -> AAGGGACCGTC
CAAGTCTTATT -> AAGTCTTATTA
CAAGTGGTATG -> AAGTGGTATGA
CAAGTTCAAAG -> AAGTTCAAAGG
CAATATTAACA -> AATATTAACAC
CAATATTACAG -> AATATTACAGG
CAATATTGTGA -> AATATTGTGAA
CAATCATCGGG -> AATCATCGGGT
CAATCCACGCT -> AATCCACGCTA
CAATCTAACAC -> AATCTAACACC
CAATTAAGGTG -> AATTAAGGTGC
CAATTATCGTC -> AATTATCGTCC
CAATTCAGCAC -> AATTCAGCACT
CAATTCGCTCC -> AATTCGCTCCT
CAATTCTAGTC -> AATTCTAGTCC
CACAAACGTCA -> ACAAACGTCAA
CACAAACTACG -> ACAAACTACGT
CACAATATTAA -> ACAATATTAAC
CACACCGCCTG -> ACACCGCCTGC
CACAGACGGAT -> ACAGACGGATT
CACAGAGGGCG -> ACAGAGGGCGC
CACATGATTAA -> ACATGATTAAC
CACATGCCAGA -> ACATGCCAGAA
CACATGGCTCC -> ACATGGCTCCT
CACCAGGGTTT -> ACCAGGGTTTG
CACCATGAGAC -> ACCATGAGACA
CACCGCCGCAT -> ACCGCCGCATT
CACCGCCTCGA -> ACCGCCTCGAC
CACCGCCTGCT -> ACCGCCTGCTA
CACCGGCGAGG -> ACCGGCGAGGC
CACCGTCAAGC -> ACCGTCAAGCA
CACCGTCACAC -> ACCGTCACACC
CACCTAGCCAA -> ACCTAGCCAAC
CACCTGTCAGA -> ACCTGTCAGAT
CACGAGGCTAA -> ACGAGGCTAAG
CACGCCGGTCT -> ACGCCGGTCTA
CACGCTAGTGG -> ACGCTAGTGGT
CACGGATACAA -> ACGGATACAAA
CACTAAAATTG -> ACTAAAATTGG
CACTAAGTAAA -> ACTAAGTAAAC
CACTAATTACC -> ACTAATTACCT
CACTACGTCGG -> ACTACGTCGGG
CACTAGAATAA -> ACTAGAATAAT
CACTGGATCAT -> ACTGGATCATT
CACTGTACACT -> ACTGTACACTT
CACTGTCAACG -> ACTGTCAACGG
CACTGTCTGCC -> ACTGTCTGCCC
CACTTAGCCAG -> ACTTAGCCAGA
CACTTATCCCC -> ACTTATCCCCT
CACTTGAGGAC -> ACTTGAGGACC
CAGAAAACGAC -> AGAAAACGACG
CAGAACGGCGC -> AGAACGGCGCG
CAGAAGCAAGG -> AGAAGCAAGGC
CAGACCCGCTC -> AGACCCGCTCT
CAGACGGATTG -> AGACGGATTGA
CAGACGTCGCG -> AGACGTCGCGT
CAGAGGGCGCC -> AGAGGGCGCCA
CAGATCACTGT -> AGATCACTGTC
CAGATGCCGAT -> AGATGCCGATG
CAGATTCGGAA -> AGATTCGGAAC
CAGCACTAATT -> AGCACTAATTA
CAGCATCATAC -> AGCATCATACG
CAGCCTACCAT -> AGCCTACCATA
CAGCGCCTATG -> AGCGCCTATGG
CAGCTGCGCTG -> AGCTGCGCTGA
CAGGACGTCAT -> AGGACGTCATT
CAGGACTTCGG -> AGGACTTCGGG
CAGGAGGTTTT -> AGGAGGTTTTC
CAGGATCTACT -> AGGATCTACTG
CAGGGACCCCT -> AGGGACCCCTA
CAGGGCAAGTC -> AGGGCAAGTCT
CAGGGTTTGTC -> AGGGTTTGTCT
CAGGTCATGCT -> AGGTCATGCTC
CAGTACGCGAT -> AGTACGCGATC
CAGTATAGTTC -> AGTATAGTTCG
CAGTCGGATTT -> AGTCGGATTTG
CAGTTATATAA -> AGTTATATAAA
CATACGCATAG -> ATACGCATAGA
CATACTTTTAG -> ATACTTTTAGA
CATAGAAGAAG -> ATAGAAGAAGT
CATAGACCATG -> ATAGACCATGT
CATAGTGGCGC -> ATAGTGGCGCC
CATATAGGCAA -> ATATAGGCAAG
CATATTGTGAC -> ATATTGTGACC
CATCATACGCA -> ATCATACGCAT
CATCCCGGTGA -> ATCCCGGTGAT
CATCCGCCCTT -> ATCCGCCCTTT
CATCGATCACC -> ATCGATCACCT
CATCGGATACT -> ATCGGATACTA
CATCGGGTACC -> ATCGGGTACCA
CATCGTGCTTT -> ATCGTGCTTTC
CATGAATTCAA -> ATGAATTCAAC
CATGAGAATAA -> ATGAGAATAAG
CATGAGACAAT -> ATGAGACAATC
CATGAGAGCTC -> ATGAGAGCTCA
CATGATTAACA -> ATGATTAACAC
CATGCACCGCC -> ATGCACCGCCT
CATGCCAGAAA -> ATGCCAGAAAA
CATGCTACATG -> ATGCTACATGA
CATGCTCGGCT -> ATGCTCGGCTG
CATGGCTCCTA -> ATGGCTCCTAT
CATGGTCTTCA -> ATGGTCTTCAT
CATGTGCCGTT -> ATGTGCCGTTG
CATGTGGTTGG -> ATGTGGTTGGA
CATTAACTTCA -> ATTAACTTCAA
CATTACCGGGC -> ATTACCGGGCG
CATTCTCGGAT -> ATTCTCGGATC
CATTGATATTT -> ATTGATATTTA
CATTGCAAAAA -> ATTGCAAAAAG
CATTGCTAAGC -> ATTGCTAAGCT
CATTGGAATAC -> ATTGGAATACC
CATTTCGGCTG -> ATTTCGGCTGT
CATTTGCGCAA -> ATTTGCGCAAC
CATTTGGCCCG -> ATTTGGCCCGT
CATTTGTCTCA -> ATTTGTCTCAT
CATTTTAATGT -> ATTTTAATGTG
CCAAAACCCAG -> CAAAACCCAGG
CCAACATGAGA -> CAACATGAGAG
CCAAGCTGCAT -> CAAGCTGCATT
CCAAGTTCAAA -> CAAGTTCAAAG
CCAATCTAACA -> CAATCTAACAC
CCAATTATCGT -> CAATTATCGTC
CCAATTCTAGT -> CAATTCTAGTC
CCACAAACGTC -> CACAAACGTCA
CCACAAACTAC -> CACAAACTACG
CCACAGAGGGC -> CACAGAGGGCG
CCACATGATTA -> CACATGATTAA
CCACCAGGGTT -> CACCAGGGTTT
CCACGAGGCTA -> CACGAGGCTAA
CCACGCCGGTC -> CACGCCGGTCT
CCACGCTAGTG -> CACGCTAGTGG
CCACTACGTCG -> CACTACGTCGG
CCACTTGAGGA -> CACTTGAGGAC
CCAGAAAACGA -> CAGAAAACGAC
CCAGACCCGCT -> CAGACCCGCTC
CCAGATGCCGA -> CAGATGCCGAT
CCAGCATTGCG -> CAGCATTGCGG
CCAGCCTACCA -> CAGCCTACCAT
CCAGCGCCTAT -> CAGCGCCTATG
CCAGGATCTAC -> CAGGATCTACT
CCAGGGTTTGT -> CAGGGTTTGTC
CCAGTCGGATT -> CAGTCGGATTT
CCATACTTTTA -> CATACTTTTAG
CCATATAGGCA -> CATATAGGCAA
CCATCGATCAC -> CATCGATCACC
CCATGAGACAA -> CATGAGACAAT
CCATGGTCTTC -> CATGGTCTTCA
CCATGTGGTTG -> CATGTGGTTGG
CCATTGATATT -> CATTGATATTT
CCATTGGAATA -> CATTGGAATAC
CCATTTGCGCA -> CATTTGCGCAA
CCCAAGCTGCA -> CCAAGCTGCAT
CCCAATTATCG -> CCAATTATCGT
CCCACAAACGT -> CCACAAACGTC
CCCAGGATCTA -> CCAGGATCTAC
CCCAGTCGGAT -> CCAGTCGGATT
CCCCGTCGGCT -> CCCGTCGGCTT
CCCCTAACCAT -> CCCTAACCATG
CCCCTAACGGA -> CCCTAACGGAC
CCCCTAGCGTT -> CCCTAGCGTTT
CCCCTCACTAG -> CCCTCACTAGA
CCCGACGGAGT -> CCGACGGAGTT
CCCGACTTAGC -> CCGACTTAGCT
CCCGAGGGCAA -> CCGAGGGCAAG
CCCGAGTTCTA -> CCGAGTTCTAG
CCCGCACCGCC -> CCGCACCGCCG
CCCGCTCTCAC -> CCGCTCTCACC
CCCGGTGATCA -> CCGGTGATCAA
CCCGTCGGCTT -> CCGTCGGCTTA
CCCGTCGTAGG -> CCGTCGTAGGT
CCCGTGATAAG -> CCGTGATAAGC
CCCTAACCATG -> CCTAACCATGG
CCCTAACGGAC -> CCTAACGGACC
CCCTAGCGTTT -> CCTAGCGTTTT
CCCTCACTAGA -> CCTCACTAGAA
CCCTCGCTACC -> CCTCGCTACCC
CCCTGCCACTA -> CCTGCCACTAC
CCCTGTACACT -> CCTGTACACTG
CCCTTATTGTG -> CCTTATTGTGT
CCCTTCACATG -> CCTTCACATGG
CCCTTTTTGAG -> CCTTTTTGAGT
CCGACAGGACT -> CGACAGGACTT
CCGACCGGACA -> CGACCGGACAA
CCGACGGAGTT -> CGACGGAGTTA
CCGACTTAGCT -> CGACTTAGCTA
CCGAGGGCAAG -> CGAGGGCAAGC
CCGAGGTGATG -> CGAGGTGATGC
CCGAGTTCTAG -> CGAGTTCTAGT
CCGATGACTTG -> CGATGACTTGG
CCGCACCGCCG -> CGCACCGCCGC
CCGCAGCATCA -> CGCAGCATCAT
CCGCAGGGCAA -> CGCAGGGCAAG
CCGCATTAACT -> CGCATTAACTT
CCGCCCTTTTT -> CGCCCTTTTTG
CCGCCGCATTA -> CGCCGCATTAA
CCGCCTCGACC -> CGCCTCGACCG
CCGCCTGCTAT -> CGCCTGCTATA
CCGCTCTCACC -> CGCTCTCACCG
CCGCTTCAACG -> CGCTTCAACGT
CCGGACAATTC -> CGGACAATTCA
CCGGCGAGGCG -> CGGCGAGGCGG
CCGGCGATGCT -> CGGCGATGCTT
CCGGCTCAAGC -> CGGCTCAAGCA
CCGGGCGAAAC -> CGGGCGAAACA
CCGGTCTAATA -> CGGTCTAATAT
CCGGTGATCAA -> CGGTGATCAAT
CCGGTTCTAGG -> CGGTTCTAGGA
CCGTCAAGCAG -> CGTCAAGCAGC
CCGTCACACCG -> CGTCACACCGC
CCGTCACTGTA -> CGTCACTGTAC
CCGTCGGCTTA -> CGTCGGCTTAA
CCGTCGTAGGT -> CGTCGTAGGTT
CCGTGATAAGC -> CGTGATAAGCC
CCGTGTGAGCG -> CGTGTGAGCGC
CCGTGTTGGTT -> CGTGTTGGTTA
CCGTTGCTTGA -> CGTTGCTTGAA
CCTAAAAGTAT -> CTAAAAGTATG
CCTAACCATGG -> CTAACCATGGT
CCTAACGGACC -> CTAACGGACCG
CCTACATGCTA -> CTACATGCTAC
CCTACCATACT -> CTACCATACTT
CCTACGTTGCC -> CTACGTTGCCC
CCTAGCCAACA -> CTAGCCAACAT
CCTAGCGTTTT -> CTAGCGTTTTT
CCTAGGCATTG -> CTAGGCATTGC
CCTATACCCGA -> CTATACCCGAC
CCTATACCTAC -> CTATACCTACG
CCTATGGCCGC -> CTATGGCCGCA
CCTCAAAACGC -> CTCAAAACGCT
CCTCAAGGGAC -> CTCAAGGGACC
CCTCACTAGAA -> CTCACTAGAAT
CCTCCTATACC -> CTCCTATACCT
CCTCCTTGGAT -> CTCCTTGGATG
CCTCGACCGCA -> CTCGACCGCAG
CCTCGCTACCC -> CTCGCTACCCC
CCTCTCTCAGA -> CTCTCTCAGAA
CCTGCCACTAC -> CTGCCACTACG
CCTGCTATATA -> CTGCTATATAG
CCTGGAAACCC -> CTGGAAACCCC
CCTGTACACTG -> CTGTACACTGT
CCTGTCAGATT -> CTGTCAGATTC
CCTTATTGTGT -> CTTATTGTGTG
CCTTCACATGG -> CTTCACATGGC
CCTTCCATTTG -> CTTCCATTTGC
CCTTCGGACGT -> CTTCGGACGTA
CCTTCTTCACA -> CTTCTTCACAA
CCTTGGATGTG -> CTTGGATGTGT
CCTTTTTGAGT -> CTTTTTGAGTA
CGAAAACCCCG -> GAAAACCCCGT
CGAAACACCTA -> GAAACACCTAG
CGAAGCCCGAC -> GAAGCCCGACG
CGACACATGCC -> GACACATGCCA
CGACAGGACTT -> GACAGGACTTC
CGACCGCAGCA -> GACCGCAGCAT
CGACCGGACAA -> GACCGGACAAT
CGACGAGTCAC -> GACGAGTCACC
CGACGGAGTTA -> GACGGAGTTAC
CGACGGCCGGC -> GACGGCCGGCT
CGACTTAGCTA -> GACTTAGCTAC
CGAGACCACAA -> GAGACCACAAA
CGAGGCGGCGA -> GAGGCGGCGAG
CGAGGCTAAGA -> GAGGCTAAGAT
CGAGGGCAAGC -> GAGGGCAAGCT
CGAGGGTAGGA -> GAGGGTAGGAC
CGAGGTGATGC -> GAGGTGATGCT
CGAGTCACCGT -> GAGTCACCGTC
CGAGTTCTAGT -> GAGTTCTAGTG
CGATCACCTGT -> GATCACCTGTC
CGATCTTTAAA -> GATCTTTAAAG
CGATGACTTGG -> GATGACTTGGT
CGATGCTTGTT -> GATGCTTGTTT
CGCAACTCCTC -> GCAACTCCTCC
CGCACCGCCGC -> GCACCGCCGCA
CGCACTAAAAT -> GCACTAAAATT
CGCAGCATCAT -> GCAGCATCATA
CGCAGGGCAAG -> GCAGGGCAAGT
CGCATAGACCA -> GCATAGACCAT
CGCATTAACTT -> GCATTAACTTC
CGCCAAGTTCA -> GCCAAGTTCAA
CGCCAGCATTG -> GCCAGCATTGC
CGCCATTGGAA -> GCCATTGGAAT
CGCCCAATTAT -> GCCCAATTATC
CGCCCTTTTTG -> GCCCTTTTTGA
CGCCGCATTAA -> GCCGCATTAAC
CGCCGGTCTAA -> GCCGGTCTAAT
CGCCTATGGCC -> GCCTATGGCCG
CGCCTCGACCG -> GCCTCGACCGC
CGCCTCTCTCA -> GCCTCTCTCAG
CGCCTGCTATA -> GCCTGCTATAT
CGCGATCTTTA -> GCGATCTTTAA
CGCGCACTAAA -> GCGCACTAAAA
CGCGGTGATCG -> GCGGTGATCGA
CGCGTCCACTT -> GCGTCCACTTG
CGCTACCCCTC -> GCTACCCCTCA
CGCTAGCATAG -> GCTAGCATAGT
CGCTAGTGGTC -> GCTAGTGGTCC
CGCTCCTTCGG -> GCTCCTTCGGA
CGCTCTCACCG -> GCTCTCACCGG
CGCTGACGGGC -> GCTGACGGGCT
CGCTTCAACGT -> GCTTCAACGTA
CGCTTGCTCCG -> GCTTGCTCCGG
CGGAACCCAGT -> GGAACCCAGTC
CGGACAATTCA -> GGACAATTCAG
CGGACCGTGTT -> GGACCGTGTTG
CGGACGTAACC -> GGACGTAACCT
CGGAGTTACCG -> GGAGTTACCGA
CGGATACAAAG -> GGATACAAAGA
CGGATACTAAA -> GGATACTAAAA
CGGATCAGTTA -> GGATCAGTTAT
CGGATTGATAG -> GGATTGATAGT
CGGATTTGATC -> GGATTTGATCT
CGGCCAGCCTA -> GGCCAGCCTAC
CGGCCCTGCCA -> GGCCCTGCCAC
CGGCCGGCTCA -> GGCCGGCTCAA
CGGCGAAAACC -> GGCGAAAACCC
CGGCGAGGCGG -> GGCGAGGCGGC
CGGCGAGGGTA -> GGCGAGGGTAG
CGGCGATGCTT -> GGCGATGCTTG
CGGCGCGCACT -> GGCGCGCACTA
CGGCGGTACGC -> GGCGGTACGCC
CGGCTAGGCGG -> GGCTAGGCGGT
CGGCTCAAGCA -> GGCTCAAGCAT
CGGCTGAGCAC -> GGCTGAGCACG
CGGCTGTAGGT -> GGCTGTAGGTT
CGGCTTAACCC -> GGCTTAACCCT
CGGGCAAAGAA -> GGGCAAAGAAG
CGGGCCTCCTA -> GGGCCTCCTAT
CGGGCGAAACA -> GGGCGAAACAC
CGGGCTTTAGC -> GGGCTTTAGCT
CGGGGATATAC -> GGGGATATACG
CGGGTACACTA -> GGGTACACTAA
CGGGTACCAAT -> GGGTACCAATT
CGGTACGCCAA -> GGTACGCCAAG
CGGTCTAATAT -> GGTCTAATATA
CGGTCTTTTGT -> GGTCTTTTGTA
CGGTGATCAAT -> GGTGATCAATT
CGGTGATCGAC -> GGTGATCGACA
CGGTGGGCCAC -> GGTGGGCCACG
CGGTGGTCATG -> GGTGGTCATGC
CGGTGTAGGCC -> GGTGTAGGCCT
CGGTTCTAGGA -> GGTTCTAGGAC
CGTAACCTCAA -> GTAACCTCAAA,GTAACCTCAAG
CGTAATAGGTT -> GTAATAGGTTA
CGTAGGTTGTC -> GTAGGTTGTCA
CGTAGTTGGGC -> GTAGTTGGGCG
CGTCAAGCAGC -> GTCAAGCAGCT
CGTCAAGTGGT -> GTCAAGTGGTA
CGTCACACCGC -> GTCACACCGCC
CGTCACTGTAC -> GTCACTGTACA
CGTCATTTTAA -> GTCATTTTAAT
CGTCCACAGAG -> GTCCACAGAGG
CGTCCACTTGA -> GTCCACTTGAG
CGTCCAGCGCC -> GTCCAGCGCCT
CGTCGACGAGT -> GTCGACGAGTC
CGTCGCGTCCA -> GTCGCGTCCAC
CGTCGGCTTAA -> GTCGGCTTAAC
CGTCGGGCAAA -> GTCGGGCAAAG
CGTCGTAGGTT -> GTCGTAGGTTG
CGTGATAAGCC -> GTGATAAGCCG
CGTGCACAGAC -> GTGCACAGACG
CGTGCTCGTAA -> GTGCTCGTAAC
CGTGCTTTCAT -> GTGCTTTCATA
CGTGTCCACCA -> GTGTCCACCAG
CGTGTGAGCGC -> GTGTGAGCGCT
CGTGTTGGTTA -> GTGTTGGTTAA
CGTTGCCCTTA -> GTTGCCCTTAT
CGTTGCTGTGA -> GTTGCTGTGAA
CGTTGCTTGAA -> GTTGCTTGAAA
CGTTTTTCCTT -> GTTTTTCCTTC
CTAAAAGTATG -> TAAAAGTATGC
CTAAAATCGGG -> TAAAATCGGGT
CTAAAATTGGG -> TAAAATTGGGT
CTAACACCGTC -> TAACACCGTCA
CTAACCATGGT -> TAACCATGGTC
CTAACGGACCG -> TAACGGACCGT
CTAAGATTTAA -> TAAGATTTAAA
CTAAGCTACTC -> TAAGCTACTCG
CTAAGTAAACG -> TAAGTAAACGG
CTAATACTCAA -> TAATACTCAAC
CTAATATACAT -> TAATATACATC
CTAATTACCTA -> TAATTACCTAC
CTACATGAATT -> TACATGAATTC
CTACATGCTAC -> TACATGCTACA
CTACCATACTT -> TACCATACTTT
CTACCCCTCAC -> TACCCCTCACT
CTACGTCGACG -> TACGTCGACGA
CTACGTCGGGC -> TACGTCGGGCA
CTACGTTGCCC -> TACGTTGCCCT
CTACTAGGCAA -> TACTAGGCAAT
CTACTCGAGAC -> TACTCGAGACC
CTACTGTGATC -> TACTGTGATCG
CTAGAATAAGG -> TAGAATAAGGG
CTAGAATAATT -> TAGAATAATTA
CTAGCATAGTG -> TAGCATAGTGG
CTAGCCAACAT -> TAGCCAACATG
CTAGCGTTTTT -> TAGCGTTTTTC
CTAGGACCAAT -> TAGGACCAATC
CTAGGCAATCA -> TAGGCAATCAT
CTAGGCATTGC -> TAGGCATTGCT
CTAGGCGGTGG -> TAGGCGGTGGG
CTAGTCCAAAA -> TAGTCCAAAAC
CTAGTGAAGAG -> TAGTGAAGAGA
CTAGTGGTCCT -> TAGTGGTCCTA
CTATACCCGAC -> TATACCCGACT
CTATACCTACG -> TATACCTACGT
CTATATAGGCG -> TATATAGGCGT
CTATGGCCGCA -> TATGGCCGCAG
CTCAAAACGCT -> TCAAAACGCTA
CTCAACAGTAC -> TCAACAGTACG
CTCAACCATTG -> TCAACCATTGA
CTCAACGGTGG -> TCAACGGTGGT
CTCAAGCATGA -> TCAAGCATGAG
CTCAAGGGACC -> TCAAGGGACCG
CTCACCGGCGA -> TCACCGGCGAG
CTCACTAGAAT -> TCACTAGAATA
CTCAGAACGGC -> TCAGAACGGCG
CTCAGAAGCAA -> TCAGAAGCAAG
CTCATGTGCCG -> TCATGTGCCGT
CTCCATATAGG -> TCCATATAGGC
CTCCGACCGGA -> TCCGACCGGAC
CTCCGGCGATG -> TCCGGCGATGC
CTCCGGTTCTA -> TCCGGTTCTAG
CTCCTATACCC -> TCCTATACCCG
CTCCTATACCT -> TCCTATACCTA
CTCCTCCTTGG -> TCCTCCTTGGA
CTCCTTCGGAC -> TCCTTCGGACG
CTCCTTGGATG -> TCCTTGGATGT
CTCGACCGCAG -> TCGACCGCAGC
CTCGAGACCAC -> TCGAGACCACA
CTCGCTACCCC -> TCGCTACCCCT
CTCGGATCAGT -> TCGGATCAGTT
CTCGGCTGAGC -> TCGGCTGAGCA
CTCGGGGATAT -> TCGGGGATATA
CTCGTAACCTC -> TCGTAACCTCA
CTCGTTGCTGT -> TCGTTGCTGTG
CTCTAATACTC -> TCTAATACTCA
CTCTCACCGGC -> TCTCACCGGCG
CTCTCAGAACG -> TCTCAGAACGG
CTCTCTCAGAA -> TCTCTCAGAAC
CTGACGGGCTT -> TGACGGGCTTT
CTGAGCACGGA -> TGAGCACGGAT
CTGCATTTGGC -> TGCATTTGGCC
CTGCATTTGTC -> TGCATTTGTCT
CTGCCACTACG -> TGCCACTACGT
CTGCCCGAGGG -> TGCCCGAGGGC
CTGCGCTGACG -> TGCGCTGACGG
CTGCTATATAG -> TGCTATATAGG
CTGGAAACCCC -> TGGAAACCCCT
CTGGATCATTG -> TGGATCATTGC
CTGGGGAGGGA -> TGGGGAGGGAC
CTGTACACTGT -> TGTACACTGTC
CTGTACACTTA -> TGTACACTTAG
CTGTAGGTTTG -> TGTAGGTTTGC
CTGTCAACGGC -> TGTCAACGGCG
CTGTCAGATTC -> TGTCAGATTCG
CTGTCTGCCCG -> TGTCTGCCCGA
CTGTGAAGTGC -> TGTGAAGTGCG
CTGTGATCGTC -> TGTGATCGTCC
CTGTTTAGCCA -> TGTTTAGCCAC
CTTAACCCTCG -> TTAACCCTCGC
CTTAGCCAGAC -> TTAGCCAGACC
CTTAGCTACTA -> TTAGCTACTAG
CTTATCCCCTA -> TTATCCCCTAA
CTTATCCCGTG -> TTATCCCGTGA
CTTATTACTAG -> TTATTACTAGA
CTTATTGTGTG -> TTATTGTGTGT
CTTCAACGTAG -> TTCAACGTAGT
CTTCAATATTG -> TTCAATATTGT
CTTCACAATAT -> TTCACAATATT
CTTCACATGGC -> TTCACATGGCT
CTTCATCGTGC -> TTCATCGTGCT
CTTCCATCGAT -> TTCCATCGATC
CTTCCATTTGC -> TTCCATTTGCG
CTTCGGACGTA -> TTCGGACGTAA
CTTCGGGCCTC -> TTCGGGCCTCC
CTTCTTCACAA -> TTCTTCACAAT
CTTGAAATTAA -> TTGAAATTAAA
CTTGAGGACCC -> TTGAGGACCCA
CTTGCTCCGGC -> TTGCTCCGGCG
CTTGGATGTGT -> TTGGATGTGTG
CTTGGCCGAGG -> TTGGCCGAGGT
CTTGGTAAAGG -> TTGGTAAAGGA
CTTGTTTCCCG -> TTGTTTCCCGC
CTTTAAAGACA -> TTTAAAGACAA
CTTTACTGCAT -> TTTACTGCATT
CTTTAGCTTCC -> TTTAGCTTCCA
CTTTCATATTG -> TTTCATATTGT
CTTTGACCAGA -> TTTGACCAGAT
CTTTTAATGGC -> TTTTAATGGCC
CTTTTAGAGAT -> TTTTAGAGATT
CTTTTGTATTT -> TTTTGTATTTC
CTTTTTGAGTA -> TTTTTGAGTAA
GAAAACCCCGT -> AAAACCCCGTC
GAAAACGACGG -> AAAACGACGGC
GAAACACCTAG -> AAACACCTAGC
GAAACCCCTAA -> AAACCCCTAAC
GAAATACTCGT -> AAATACTCGTT
GAAATTAAAAC -> AAATTAAAACA
GAACCCAGTCG -> AACCCAGTCGG
GAACGGCGCGC -> AACGGCGCGCA
GAACTGGGGAG -> AACTGGGGAGG
GAAGAAGTACT -> AAGAAGTACTC
GAAGAGACTGT -> AAGAGACTGTT
GAAGCAAGGCC -> AAGCAAGGCCG
GAAGCCCGACG -> AAGCCCGACGG
GAAGGCTTATC -> AAGGCTTATCC
GAAGTACTCTA -> AAGTACTCTAA
GAAGTGCGAAG -> AAGTGCGAAGC
GAATAAGCAGA -> AATAAGCAGAT
GAATAAGGGGA -> AATAAGGGGAC
GAATAATTAGA -> AATAATTAGAG
GAATACCACGC -> AATACCACGCC
GAATTCAACAT -> AATTCAACATT
GACAATATTAC -> ACAATATTACA
GACAATCCACG -> ACAATCCACGC
GACAATTCAGC -> ACAATTCAGCA
GACACATGCCA -> ACACATGCCAG
GACAGGACTTC -> ACAGGACTTCG
GACAGGTCATG -> ACAGGTCATGC
GACATTCTCGG -> ACATTCTCGGA
GACCAATCTAA -> ACCAATCTAAC
GACCACAAACT -> ACCACAAACTA
GACCAGATGCC -> ACCAGATGCCG
GACCATGTGGT -> ACCATGTGGTT
GACCCAAGCTG -> ACCCAAGCTGC
GACCCACAAAC -> ACCCACAAACG
GACCCCTAGCG -> ACCCCTAGCGT
GACCCGAGTTC -> ACCCGAGTTCT
GACCCGCTCTC -> ACCCGCTCTCA
GACCGCAGCAT -> ACCGCAGCATC
GACCGGACAAT -> ACCGGACAATT
GACCGTCACTG -> ACCGTCACTGT
GACCGTGTTGG -> ACCGTGTTGGT
GACCTAGGCAT -> ACCTAGGCATT
GACGAGTCACC -> ACGAGTCACCG
GACGGAGTTAC -> ACGGAGTTACC
GACGGATTGAT -> ACGGATTGATA
GACGGCCGGCT -> ACGGCCGGCTC
GACGGGCTTTA -> ACGGGCTTTAG
GACGTAACCTC -> ACGTAACCTCA
GACGTCATTTT -> ACGTCATTTTA
GACGTCGCGTC -> ACGTCGCGTCC
GACTCAACGGT -> ACTCAACGGTG
GACTGTTTAGC -> ACTGTTTAGCC
GACTTAGCTAC -> ACTTAGCTACT
GACTTCGGGCC -> ACTTCGGGCCT
GACTTGGTAAA -> ACTTGGTAAAG
GAGAATAAGCA -> AGAATAAGCAG
GAGACAATCCA -> AGACAATCCAC
GAGACCACAAA -> AGACCACAAAC
GAGACTGTTTA -> AGACTGTTTAG
GAGAGCTCAGA -> AGAGCTCAGAA
GAGATTACAAA -> AGATTACAAAG
GAGCACGGATA -> AGCACGGATAC
GAGCAGGGACC -> AGCAGGGACCC
GAGCGCTTGCT -> AGCGCTTGCTC
GAGCTCAGAAG -> AGCTCAGAAGC
GAGGACCCACA -> AGGACCCACAA
GAGGCGGCGAG -> AGGCGGCGAGG
GAGGCTAAGAT -> AGGCTAAGATT
GAGGGACAGGT -> AGGGACAGGTC
GAGGGCAAGCT -> AGGGCAAGCTT
GAGGGCGCCAG -> AGGGCGCCAGC
GAGGGCGGTCT -> AGGGCGGTCTT
GAGGGTAGGAC -> AGGGTAGGACC
GAGGTGATGCT -> AGGTGATGCTC
GAGGTTTTCCC -> AGGTTTTCCCT
GAGTAACGTGC -> AGTAACGTGCT
GAGTCACCGTC -> AGTCACCGTCA
GAGTGTTTCAC -> AGTGTTTCACT
GAGTTACCGAC -> AGTTACCGACA
GAGTTCTAGTG -> AGTTCTAGTGA
GATAAGCCGCT -> ATAAGCCGCTT
GATACAAAGAG -> ATACAAAGAGC
GATACTAAAAT -> ATACTAAAATC
GATAGTGCTCG -> ATAGTGCTCGG
GATATACGGTG -> ATATACGGTGT
GATATTTAGGA -> ATATTTAGGAC
GATCAATTCGC -> ATCAATTCGCT
GATCACCTGTC -> ATCACCTGTCA
GATCACTGTCT -> ATCACTGTCTG
GATCAGTTATA -> ATCAGTTATAT
GATCATTGCAA -> ATCATTGCAAA
GATCGACACAT -> ATCGACACATG
GATCGTCCACA -> ATCGTCCACAG
GATCTACTGTG -> ATCTACTGTGA
GATCTCCATAT -> ATCTCCATATA
GATCTTTAAAG -> ATCTTTAAAGA
GATGACTTGGT -> ATGACTTGGTA
GATGCCGATGA -> ATGCCGATGAC
GATGCTCAACC -> ATGCTCAACCA
GATGCTTGTTT -> ATGCTTGTTTC
GATGGGTCGCG -> ATGGGTCGCGG
GATGTGTGATG -> ATGTGTGATGG
GATTAACACCA -> ATTAACACCAT
GATTACAAAGT -> ATTACAAAGTC
GATTATTTGTA -> ATTATTTGTAC
GATTCGGAACC -> ATTCGGAACCC
GATTGATAGTG -> ATTGATAGTGC
GATTTAAACAG -> ATTTAAACAGT
GATTTGATCTC -> ATTTGATCTCC
GATTTGCGGCG -> ATTTGCGGCGA
GCAAAAAGGCG -> CAAAAAGGCGG
GCAAAGAAGGC -> CAAAGAAGGCT
GCAACTCCTCC -> CAACTCCTCCT
GCAAGCTTTAC -> CAAGCTTTACT
GCAAGGATTAT -> CAAGGATTATT
GCAAGGCCGTG -> CAAGGCCGTGT
GCAAGTCTTAT -> CAAGTCTTATT
GCAATCATCGG -> CAATCATCGGG
GCAATTAAGGT -> CAATTAAGGTG
GCACAGACGGA -> CACAGACGGAT
GCACCGCCGCA -> CACCGCCGCAT
GCACCGCCTCG -> CACCGCCTCGA
GCACGGATACA -> CACGGATACAA
GCACTAAAATT -> CACTAAAATTG
GCACTAATTAC -> CACTAATTACC
GCAGATCACTG -> CAGATCACTGT
GCAGCATCATA -> CAGCATCATAC
GCAGCTGCGCT -> CAGCTGCGCTG
GCAGGACGTCA -> CAGGACGTCAT
GCAGGGACCCC -> CAGGGACCCCT
GCAGGGCAAGT -> CAGGGCAAGTC
GCATAGAAGAA -> CATAGAAGAAG
GCATAGACCAT -> CATAGACCATG
GCATAGTGGCG -> CATAGTGGCGC
GCATCATACGC -> CATCATACGCA
GCATCCGCCCT -> CATCCGCCCTT
GCATGAGAATA -> CATGAGAATAA
GCATTAACTTC -> CATTAACTTCA
GCATTGCTAAG -> CATTGCTAAGC
GCATTTGGCCC -> CATTTGGCCCG
GCATTTGTCTC -> CATTTGTCTCA
GCCAACATGAG -> CCAACATGAGA
GCCAAGTTCAA -> CCAAGTTCAAA
GCCACATGATT -> CCACATGATTA
GCCACGAGGCT -> CCACGAGGCTA
GCCACTACGTC -> CCACTACGTCG
GCCAGAAAACG -> CCAGAAAACGA
GCCAGACCCGC -> CCAGACCCGCT
GCCAGCATTGC -> CCAGCATTGCG
GCCAGCCTACC -> CCAGCCTACCA
GCCATTGGAAT -> CCATTGGAATA
GCCCAATTATC -> CCCAATTATCG
GCCCGACGGAG -> CCCGACGGAGT
GCCCGAGGGCA -> CCCGAGGGCAA
GCCCGTCGTAG -> CCCGTCGTAGG
GCCCTGCCACT -> CCCTGCCACTA
GCCCTTATTGT -> CCCTTATTGTG
GCCCTTTTTGA -> CCCTTTTTGAG
GCCGAGGTGAT -> CCGAGGTGATG
GCCGATGACTT -> CCGATGACTTG
GCCGCAGGGCA -> CCGCAGGGCAA
GCCGCATTAAC -> CCGCATTAACT
GCCGCTTCAAC -> CCGCTTCAACG
GCCGGCTCAAG -> CCGGCTCAAGC
GCCGGTCTAAT -> CCGGTCTAATA
GCCGTGTGAGC -> CCGTGTGAGCG
GCCGTTGCTTG -> CCGTTGCTTGA
GCCTACCATAC -> CCTACCATACT
GCCTATGGCCG -> CCTATGGCCGC
GCCTCCTATAC -> CCTCCTATACC
GCCTCGACCGC -> CCTCGACCGCA
GCCTCTCTCAG -> CCTCTCTCAGA
GCCTGCTATAT -> CCTGCTATATA
GCCTGGAAACC -> CCTGGAAACCC
GCCTTCCATTT -> CCTTCCATTTG
GCGAAAACCCC -> CGAAAACCCCG
GCGAAACACCT -> CGAAACACCTA
GCGAAGCCCGA -> CGAAGCCCGAC
GCGAGGCGGCG -> CGAGGCGGCGA
GCGAGGGTAGG -> CGAGGGTAGGA
GCGATCTTTAA -> CGATCTTTAAA
GCGATGCTTGT -> CGATGCTTGTT
GCGCAACTCCT -> CGCAACTCCTC
GCGCACTAAAA -> CGCACTAAAAT
GCGCCAGCATT -> CGCCAGCATTG
GCGCCATTGGA -> CGCCATTGGAA
GCGCCCAATTA -> CGCCCAATTAT
GCGCCTATGGC -> CGCCTATGGCC
GCGCGCACTAA -> CGCGCACTAAA
GCGCTGACGGG -> CGCTGACGGGC
GCGCTTGCTCC -> CGCTTGCTCCG
GCGGCCAGCCT -> CGGCCAGCCTA
GCGGCCCTGCC -> CGGCCCTGCCA
GCGGCGAAAAC -> CGGCGAAAACC
GCGGCGAGGGT -> CGGCGAGGGTA
GCGGTACGCCA -> CGGTACGCCAA
GCGGTCTTTTG -> CGGTCTTTTGT
GCGGTGATCGA -> CGGTGATCGAC
GCGGTGGGCCA -> CGGTGGGCCAC
GCGTAATAGGT -> CGTAATAGGTT
GCGTCCACTTG -> CGTCCACTTGA
GCGTGCACAGA -> CGTGCACAGAC
GCGTTTTTCCT -> CGTTTTTCCTT
GCTAAGATTTA -> CTAAGATTTAA
GCTAAGCTACT -> CTAAGCTACTC
GCTACATGAAT -> CTACATGAATT
GCTACCCCTCA -> CTACCCCTCAC
GCTACTAGGCA -> CTACTAGGCAA
GCTACTCGAGA -> CTACTCGAGAC
GCTAGCATAGT -> CTAGCATAGTG
GCTAGGCGGTG -> CTAGGCGGTGG
GCTAGTGGTCC -> CTAGTGGTCCT
GCTATATAGGC -> CTATATAGGCG
GCTCAACCATT -> CTCAACCATTG
GCTCAAGCATG -> CTCAAGCATGA
GCTCAGAAGCA -> CTCAGAAGCAA
GCTCCGGCGAT -> CTCCGGCGATG
GCTCCTATACC -> CTCCTATACCC
GCTCCTTCGGA -> CTCCTTCGGAC
GCTCGGCTGAG -> CTCGGCTGAGC
GCTCGGGGATA -> CTCGGGGATAT
GCTCGTAACCT -> CTCGTAACCTC
GCTCTCACCGG -> CTCTCACCGGC
GCTGACGGGCT -> CTGACGGGCTT
GCTGAGCACGG -> CTGAGCACGGA
GCTGCATTTGG -> CTGCATTTGGC
GCTGCGCTGAC -> CTGCGCTGACG
GCTGTAGGTTT -> CTGTAGGTTTG
GCTGTGAAGTG -> CTGTGAAGTGC
GCTTAACCCTC -> CTTAACCCTCG
GCTTATCCCGT -> CTTATCCCGTG
GCTTCAACGTA -> CTTCAACGTAG
GCTTCCATCGA -> CTTCCATCGAT
GCTTGAAATTA -> CTTGAAATTAA
GCTTGCTCCGG -> CTTGCTCCGGC
GCTTGTTTCCC -> CTTGTTTCCCG
GCTTTACTGCA -> CTTTACTGCAT
GCTTTAGCTTC -> CTTTAGCTTCC
GCTTTCATATT -> CTTTCATATTG
GCTTTTAATGG -> CTTTTAATGGC
GGAAACCCCTA -> GAAACCCCTAA
GGAACCCAGTC -> GAACCCAGTCG
GGAATACCACG -> GAATACCACGC
GGACAATTCAG -> GACAATTCAGC
GGACAGGTCAT -> GACAGGTCATG
GGACATTCTCG -> GACATTCTCGG
GGACCAATCTA -> GACCAATCTAA
GGACCCAAGCT -> GACCCAAGCTG
GGACCCACAAA -> GACCCACAAAC
GGACCCCTAGC -> GACCCCTAGCG
GGACCGTCACT -> GACCGTCACTG
GGACCGTGTTG -> GACCGTGTTGG
GGACCTAGGCA -> GACCTAGGCAT
GGACGTAACCT -> GACGTAACCTC
GGACGTCATTT -> GACGTCATTTT
GGACTCAACGG -> GACTCAACGGT
GGACTTCGGGC -> GACTTCGGGCC
GGAGGGACAGG -> GAGGGACAGGT
GGAGGTTTTCC -> GAGGTTTTCCC
GGAGTTACCGA -> GAGTTACCGAC
GGATACAAAGA -> GATACAAAGAG
GGATACTAAAA -> GATACTAAAAT
GGATATACGGT -> GATATACGGTG
GGATCAGTTAT -> GATCAGTTATA
GGATCATTGCA -> GATCATTGCAA
GGATCTACTGT -> GATCTACTGTG
GGATGTGTGAT -> GATGTGTGATG
GGATTATTTGT -> GATTATTTGTA
GGATTGATAGT -> GATTGATAGTG
GGATTTGATCT -> GATTTGATCTC
GGATTTGCGGC -> GATTTGCGGCG
GGCAAAGAAGG -> GCAAAGAAGGC
GGCAAGCTTTA -> GCAAGCTTTAC
GGCAAGGATTA -> GCAAGGATTAT
GGCAAGTCTTA -> GCAAGTCTTAT
GGCAATCATCG -> GCAATCATCGG
GGCAGGACGTC -> GCAGGACGTCA
GGCATTGCTAA -> GCATTGCTAAG
GGCCACGAGGC -> GCCACGAGGCT
GGCCAGCCTAC -> GCCAGCCTACC
GGCCCGTCGTA -> GCCCGTCGTAG
GGCCCTGCCAC -> GCCCTGCCACT
GGCCGAGGTGA -> GCCGAGGTGAT
GGCCGCAGGGC -> GCCGCAGGGCA
GGCCGGCTCAA -> GCCGGCTCAAG
GGCCGTGTGAG -> GCCGTGTGAGC
GGCCTCCTATA -> GCCTCCTATAC
GGCCTGGAAAC -> GCCTGGAAACC
GGCCTTCCATT -> GCCTTCCATTT
GGCGAAAACCC -> GCGAAAACCCC
GGCGAAACACC -> GCGAAACACCT
GGCGAGGCGGC -> GCGAGGCGGCG
GGCGAGGGTAG -> GCGAGGGTAGG
GGCGATGCTTG -> GCGATGCTTGT
GGCGCCAGCAT -> GCGCCAGCATT
GGCGCCATTGG -> GCGCCATTGGA
GGCGCCCAATT -> GCGCCCAATTA
GGCGCGCACTA -> GCGCGCACTAA
GGCGGCCAGCC -> GCGGCCAGCCT
GGCGGCCCTGC -> GCGGCCCTGCC
GGCGGCGAGGG -> GCGGCGAGGGT
GGCGGTACGCC -> GCGGTACGCCA
GGCGGTCTTTT -> GCGGTCTTTTG
GGCGGTGGGCC -> GCGGTGGGCCA
GGCGTGCACAG -> GCGTGCACAGA
GGCTAAGATTT -> GCTAAGATTTA
GGCTAGGCGGT -> GCTAGGCGGTG
GGCTCAAGCAT -> GCTCAAGCATG
GGCTCCTATAC -> GCTCCTATACC
GGCTGAGCACG -> GCTGAGCACGG
GGCTGTAGGTT -> GCTGTAGGTTT
GGCTTAACCCT -> GCTTAACCCTC
GGCTTATCCCG -> GCTTATCCCGT
GGCTTTAGCTT -> GCTTTAGCTTC
GGGACAGGTCA -> GGACAGGTCAT
GGGACCCCTAG -> GGACCCCTAGC
GGGACCGTCAC -> GGACCGTCACT
GGGACCTAGGC -> GGACCTAGGCA
GGGAGGGACAG -> GGAGGGACAGG
GGGATATACGG -> GGATATACGGT
GGGCAAAGAAG -> GGCAAAGAAGG
GGGCAAGCTTT -> GGCAAGCTTTA
GGGCAAGTCTT -> GGCAAGTCTTA
GGGCCACGAGG -> GGCCACGAGGC
GGGCCTCCTAT -> GGCCTCCTATA
GGGCGAAACAC -> GGCGAAACACC
GGGCGCCAGCA -> GGCGCCAGCAT
GGGCGCCATTG -> GGCGCCATTGG
GGGCGGTCTTT -> GGCGGTCTTTT
GGGCTTTAGCT -> GGCTTTAGCTT
GGGGACCTAGG -> GGGACCTAGGC
GGGGAGGGACA -> GGGAGGGACAG
GGGGATATACG -> GGGATATACGG
GGGTACACTAA -> GGTACACTAAG
GGGTACCAATT -> GGTACCAATTC
GGGTAGAGTGT -> GGTAGAGTGTT
GGGTAGGACCC -> GGTAGGACCCA
GGGTCGCGGTG -> GGTCGCGGTGA
GGGTTTGTCTT -> GGTTTGTCTTG
GGTAAAGGACT -> GTAAAGGACTC
GGTACACTAAG -> GTACACTAAGT
GGTACCAATTC -> GTACCAATTCT
GGTACGCCAAG -> GTACGCCAAGT
GGTAGAGTGTT -> GTAGAGTGTTT
GGTAGGACCCA -> GTAGGACCCAA
GGTATGAACTG -> GTATGAACTGG
GGTCATGCACC -> GTCATGCACCG
GGTCATGCTCG -> GTCATGCTCGG
GGTCCTAAAAG -> GTCCTAAAAGT
GGTCGCGGTGA -> GTCGCGGTGAT
GGTCTAATATA -> GTCTAATATAC
GGTCTTCATCG -> GTCTTCATCGT
GGTCTTTTGTA -> GTCTTTTGTAT
GGTGATCAATT -> GTGATCAATTC
GGTGATCGACA -> GTGATCGACAC
GGTGATGCTCA -> GTGATGCTCAA
GGTGCTTTTAA -> GTGCTTTTAAT
GGTGGGCCACG -> GTGGGCCACGA
GGTGGTCATGC -> GTGGTCATGCA
GGTGTAGGCCT -> GTGTAGGCCTT
GGTTAACTCCG -> GTTAACTCCGA
GGTTACTTTGA -> GTTACTTTGAC
GGTTCTAGGAC -> GTTCTAGGACC
GGTTGGATTTG -> GTTGGATTTGC
GGTTGTCAGAC -> GTTGTCAGACG
GGTTTGCAATT -> GTTTGCAATTA
GGTTTGTCTTG -> GTTTGTCTTGG
GGTTTTCCCTT -> GTTTTCCCTTC
GTAAACGGCTA -> TAAACGGCTAG
GTAAAGGACTC -> TAAAGGACTCA
GTAACCTCAAA -> TAACCTCAAAA
GTAACCTCAAG -> TAACCTCAAGG
GTAACGTGCTC -> TAACGTGCTCG
GTAATAGGTTA -> TAATAGGTTAC
GTACACTAAGT -> TACACTAAGTA
GTACACTGTCA -> TACACTGTCAA
GTACACTTAGC -> TACACTTAGCC
GTACCAATTCT -> TACCAATTCTA
GTACGCCAAGT -> TACGCCAAGTT
GTACGCGATCT -> TACGCGATCTT
GTACGTGTCCA -> TACGTGTCCAC
GTACTCTAATA -> TACTCTAATAC
GTAGAGTGTTT -> TAGAGTGTTTC
GTAGGACCCAA -> TAGGACCCAAG
GTAGGCCTTCC -> TAGGCCTTCCA
GTAGGCGGCCA -> TAGGCGGCCAG
GTAGGTTGTCA -> TAGGTTGTCAG
GTAGGTTTGCA -> TAGGTTTGCAA
GTAGTTGGGCG -> TAGTTGGGCGC
GTATAGTTCGC -> TATAGTTCGCC
GTATGAACTGG -> TATGAACTGGG
GTATGCATAGA -> TATGCATAGAA
GTATTTCATCG -> TATTTCATCGG
GTCAACGGCGG -> TCAACGGCGGT
GTCAAGCAGCT -> TCAAGCAGCTG
GTCAAGTGGTA -> TCAAGTGGTAT
GTCACACCGCC -> TCACACCGCCT
GTCACCGTCAA -> TCACCGTCAAG
GTCACTGTACA -> TCACTGTACAC
GTCAGACGTCG -> TCAGACGTCGC
GTCAGATTCGG -> TCAGATTCGGA
GTCATGCACCG -> TCATGCACCGC
GTCATGCTCGG -> TCATGCTCGGC
GTCATTTTAAT -> TCATTTTAATG
GTCCAAAACCC -> TCCAAAACCCA
GTCCACAGAGG -> TCCACAGAGGG
GTCCACCAGGG -> TCCACCAGGGT
GTCCACTTGAG -> TCCACTTGAGG
GTCCAGCGCCT -> TCCAGCGCCTA
GTCCCTGTACA -> TCCCTGTACAC
GTCCTAAAAGT -> TCCTAAAAGTA
GTCGACGAGTC -> TCGACGAGTCA
GTCGCGGTGAT -> TCGCGGTGATC
GTCGCGTCCAC -> TCGCGTCCACT
GTCGGATTTGA -> TCGGATTTGAT
GTCGGCTTAAC -> TCGGCTTAACC
GTCGGGCAAAG -> TCGGGCAAAGA
GTCGTAGGTTG -> TCGTAGGTTGT
GTCTAATATAC -> TCTAATATACA
GTCTCATGTGC -> TCTCATGTGCC
GTCTGCCCGAG -> TCTGCCCGAGG
GTCTTATTACT -> TCTTATTACTA
GTCTTCATCGT -> TCTTCATCGTG
GTCTTGGCCGA -> TCTTGGCCGAG
GTCTTTTGTAT -> TCTTTTGTATT
GTGAAATACTC -> TGAAATACTCG
GTGAAGAGACT -> TGAAGAGACTG
GTGAAGTGCGA -> TGAAGTGCGAA
GTGACCCGAGT -> TGACCCGAGTT
GTGAGCGCTTG -> TGAGCGCTTGC
GTGATAAGCCG -> TGATAAGCCGC
GTGATCAATTC -> TGATCAATTCG
GTGATCGACAC -> TGATCGACACA
GTGATCGTCCA -> TGATCGTCCAC
GTGATGCTCAA -> TGATGCTCAAC
GTGATGGGTCG -> TGATGGGTCGC
GTGCACAGACG -> TGCACAGACGG
GTGCATCCGCC -> TGCATCCGCCC
GTGCCGTTGCT -> TGCCGTTGCTT
GTGCGAAGCCC -> TGCGAAGCCCG
GTGCTCGGGGA -> TGCTCGGGGAT
GTGCTCGTAAC -> TGCTCGTAACC
GTGCTTTCATA -> TGCTTTCATAT
GTGCTTTTAAT -> TGCTTTTAATG
GTGGCGCCCAA -> TGGCGCCCAAT
GTGGGCCACGA -> TGGGCCACGAG
GTGGTATGAAC -> TGGTATGAACT
GTGGTCATGCA -> TGGTCATGCAC
GTGGTCCTAAA -> TGGTCCTAAAA
GTGGTTGGATT -> TGGTTGGATTT
GTGTAGGCCTT -> TGTAGGCCTTC
GTGTAGGCGGC -> TGTAGGCGGCC
GTGTCCACCAG -> TGTCCACCAGG
GTGTGAGCGCT -> TGTGAGCGCTT
GTGTGATGGGT -> TGTGATGGGTC
GTGTGTAGGCG -> TGTGTAGGCGG
GTGTTGGTTAA -> TGTTGGTTAAC
GTGTTTCACTT -> TGTTTCACTTA
GTTAACTCCGA -> TTAACTCCGAC
GTTACCGACAG -> TTACCGACAGG
GTTACTTTGAC -> TTACTTTGACC
GTTATATAAAG -> TTATATAAAGC
GTTCAAAGGCA -> TTCAAAGGCAG
GTTCGCCTCTC -> TTCGCCTCTCT
GTTCTAGGACC -> TTCTAGGACCA
GTTCTAGTGAA -> TTCTAGTGAAG
GTTGCCCTTAT -> TTGCCCTTATT
GTTGCTGTGAA -> TTGCTGTGAAG
GTTGCTTGAAA -> TTGCTTGAAAT
GTTGGATTTGC -> TTGGATTTGCG
GTTGGGCGCCA -> TTGGGCGCCAT
GTTGGTTAACT -> TTGGTTAACTC
GTTGTCAGACG -> TTGTCAGACGT
GTTTAGCCACA -> TTTAGCCACAT
GTTTCACTTAT -> TTTCACTTATC
GTTTCCCGCAC -> TTTCCCGCACC
GTTTGCAATTA -> TTTGCAATTAA
GTTTGTCTTGG -> TTTGTCTTGGC
GTTTTCCCTTC -> TTTTCCCTTCA
GTTTTTCCTTC -> TTTTTCCTTCT
TAAAACATTTC -> AAAACATTTCG
TAAAAGTATGC -> AAAAGTATGCA
TAAAATCGGGT -> AAAATCGGGTA
TAAAATTGGGT -> AAAATTGGGTA
TAAACAGTATA -> AAACAGTATAG
TAAACGGCTAG -> AAACGGCTAGG
TAAAGACAATA -> AAAGACAATAT
TAAAGCGTAAT -> AAAGCGTAATA
TAAAGGACTCA -> AAAGGACTCAA
TAACACCATGA -> AACACCATGAG
TAACACCGTCA -> AACACCGTCAC
TAACACTGGAT -> AACACTGGATC
TAACCATGGTC -> AACCATGGTCT
TAACCCTCGCT -> AACCCTCGCTA
TAACCTCAAAA -> AACCTCAAAAC
TAACCTCAAGG -> AACCTCAAGGG
TAACGGACCGT -> AACGGACCGTG
TAACGTGCTCG -> AACGTGCTCGT
TAACTCCGACC -> AACTCCGACCG
TAACTTCAATA -> AACTTCAATAT
TAAGATTTAAA -> AAGATTTAAAC
TAAGCAGATCA -> AAGCAGATCAC
TAAGCCGCTTC -> AAGCCGCTTCA
TAAGCTACTCG -> AAGCTACTCGA
TAAGGGGACCT -> AAGGGGACCTA
TAAGGTGCTTT -> AAGGTGCTTTT
TAAGTAAACGG -> AAGTAAACGGC
TAATACTCAAC -> AATACTCAACA
TAATAGGTTAC -> AATAGGTTACT
TAATATACATC -> AATATACATCC
TAATGGCCTGG -> AATGGCCTGGA
TAATGTGCATC -> AATGTGCATCC
TAATTACCTAC -> AATTACCTACA
TAATTAGAGGG -> AATTAGAGGGC
TACAAAGAGCA -> ACAAAGAGCAG
TACAAAGTCCC -> ACAAAGTCCCT
TACACTAAGTA -> ACACTAAGTAA
TACACTGTCAA -> ACACTGTCAAC
TACACTTAGCC -> ACACTTAGCCA
TACAGGAGGTT -> ACAGGAGGTTT
TACATCCCGGT -> ACATCCCGGTG
TACATGAATTC -> ACATGAATTCA
TACATGCTACA -> ACATGCTACAT
TACCAATTCTA -> ACCAATTCTAG
TACCACGCCGG -> ACCACGCCGGT
TACCATACTTT -> ACCATACTTTT
TACCCCTCACT -> ACCCCTCACTA
TACCCGACTTA -> ACCCGACTTAG
TACCGACAGGA -> ACCGACAGGAC
TACCGGGCGAA -> ACCGGGCGAAA
TACCTACATGC -> ACCTACATGCT
TACCTACGTTG -> ACCTACGTTGC
TACGCATAGAC -> ACGCATAGACC
TACGCCAAGTT -> ACGCCAAGTTC
TACGCGATCTT -> ACGCGATCTTT
TACGGTGTAGG -> ACGGTGTAGGC
TACGTCGACGA -> ACGTCGACGAG
TACGTCGGGCA -> ACGTCGGGCAA
TACGTGTCCAC -> ACGTGTCCACC
TACGTTGCCCT -> ACGTTGCCCTT
TACTAAAATCG -> ACTAAAATCGG
TACTAGAATAA -> ACTAGAATAAG
TACTAGGCAAT -> ACTAGGCAATC
TACTCAACAGT -> ACTCAACAGTA
TACTCGAGACC -> ACTCGAGACCA
TACTCGTTGCT -> ACTCGTTGCTG
TACTCTAATAC -> ACTCTAATACT
TACTGCATTTG -> ACTGCATTTGT
TACTGTGATCG -> ACTGTGATCGT
TACTTTGACCA -> ACTTTGACCAG
TACTTTTAGAG -> ACTTTTAGAGA
TAGAAGAAGTA -> AGAAGAAGTAC
TAGAATAAGGG -> AGAATAAGGGG
TAGAATAATTA -> AGAATAATTAG
TAGACCATGTG -> AGACCATGTGG
TAGAGATTACA -> AGAGATTACAA
TAGAGGGCGGT -> AGAGGGCGGTC
TAGAGTGTTTC -> AGAGTGTTTCA
TAGCATAGTGG -> AGCATAGTGGC
TAGCCAACATG -> AGCCAACATGA
TAGCCACATGA -> AGCCACATGAT
TAGCCAGACCC -> AGCCAGACCCG
TAGCGTTTTTC -> AGCGTTTTTCC
TAGCTACTAGG -> AGCTACTAGGC
TAGCTTCCATC -> AGCTTCCATCG
TAGGACATTCT -> AGGACATTCTC
TAGGACCAATC -> AGGACCAATCT
TAGGACCCAAG -> AGGACCCAAGC
TAGGCAAGGAT -> AGGCAAGGATT
TAGGCAATCAT -> AGGCAATCATC
TAGGCATTGCT -> AGGCATTGCTA
TAGGCCTTCCA -> AGGCCTTCCAT
TAGGCGGCCAG -> AGGCGGCCAGC
TAGGCGGTGGG -> AGGCGGTGGGC
TAGGCGTGCAC -> AGGCGTGCACA
TAGGTTACTTT -> AGGTTACTTTG
TAGGTTGTCAG -> AGGTTGTCAGA
TAGGTTTGCAA -> AGGTTTGCAAT
TAGTCCAAAAC -> AGTCCAAAACC
TAGTGAAGAGA -> AGTGAAGAGAC
TAGTGCTCGGG -> AGTGCTCGGGG
TAGTGGCGCCC -> AGTGGCGCCCA
TAGTGGTCCTA -> AGTGGTCCTAA
TAGTTCGCCTC -> AGTTCGCCTCT
TAGTTGGGCGC -> AGTTGGGCGCC
TATAAAGCGTA -> ATAAAGCGTAA
TATACATCCCG -> ATACATCCCGG
TATACCCGACT -> ATACCCGACTT
TATACCTACGT -> ATACCTACGTT
TATACGGTGTA -> ATACGGTGTAG
TATAGGCAAGG -> ATAGGCAAGGA
TATAGGCGTGC -> ATAGGCGTGCA
TATAGTTCGCC -> ATAGTTCGCCT
TATATAAAGCG -> ATATAAAGCGT
TATATAGGCGT -> ATATAGGCGTG
TATCCCCTAAC -> ATCCCCTAACC
TATCCCGTGAT -> ATCCCGTGATA
TATCGTCCAGC -> ATCGTCCAGCG
TATGAACTGGG -> ATGAACTGGGG
TATGCATAGAA -> ATGCATAGAAG
TATGGCCGCAG -> ATGGCCGCAGG
TATTAACACTG -> ATTAACACTGG
TATTACAGGAG -> ATTACAGGAGG
TATTACTAGAA -> ATTACTAGAAT
TATTGTGAAAT -> ATTGTGAAATA
TATTGTGACCC -> ATTGTGACCCG
TATTGTGTGTA -> ATTGTGTGTAG
TATTTAGGACA -> ATTTAGGACAT
TATTTCATCGG -> ATTTCATCGGA
TATTTGTACGT -> ATTTGTACGTG
TCAAAACGCTA -> CAAAACGCTAG
TCAAAGGCAGG -> CAAAGGCAGGA
TCAACAGTACG -> CAACAGTACGC
TCAACATTACC -> CAACATTACCG
TCAACCATTGA -> CAACCATTGAT
TCAACGGCGGT -> CAACGGCGGTA
TCAACGGTGGT -> CAACGGTGGTC
TCAACGTAGTT -> CAACGTAGTTG
TCAAGCAGCTG -> CAAGCAGCTGC
TCAAGCATGAG -> CAAGCATGAGA
TCAAGGGACCG -> CAAGGGACCGT
TCAAGTGGTAT -> CAAGTGGTATG
TCAATATTGTG -> CAATATTGTGA
TCAATTCGCTC -> CAATTCGCTCC
TCACAATATTA -> CACAATATTAA
TCACACCGCCT -> CACACCGCCTG
TCACATGGCTC -> CACATGGCTCC
TCACCGGCGAG -> CACCGGCGAGG
TCACCGTCAAG -> CACCGTCAAGC
TCACCTGTCAG -> CACCTGTCAGA
TCACTAGAATA -> CACTAGAATAA
TCACTGTACAC -> CACTGTACACT
TCACTGTCTGC -> CACTGTCTGCC
TCACTTATCCC -> CACTTATCCCC
TCAGAACGGCG -> CAGAACGGCGC
TCAGAAGCAAG -> CAGAAGCAAGG
TCAGACGTCGC -> CAGACGTCGCG
TCAGATTCGGA -> CAGATTCGGAA
TCAGCACTAAT -> CAGCACTAATT
TCAGTTATATA -> CAGTTATATAA
TCATACGCATA -> CATACGCATAG
TCATATTGTGA -> CATATTGTGAC
TCATCGGATAC -> CATCGGATACT
TCATCGGGTAC -> CATCGGGTACC
TCATCGTGCTT -> CATCGTGCTTT
TCATGCACCGC -> CATGCACCGCC
TCATGCTCGGC -> CATGCTCGGCT
TCATGTGCCGT -> CATGTGCCGTT
TCATTGCAAAA -> CATTGCAAAAA
TCATTTTAATG -> CATTTTAATGT
TCCAAAACCCA -> CCAAAACCCAG
TCCACAGAGGG -> CCACAGAGGGC
TCCACCAGGGT -> CCACCAGGGTT
TCCACGCTAGT -> CCACGCTAGTG
TCCACTTGAGG -> CCACTTGAGGA
TCCAGCGCCTA -> CCAGCGCCTAT
TCCATATAGGC -> CCATATAGGCA
TCCATCGATCA -> CCATCGATCAC
TCCATTTGCGC -> CCATTTGCGCA
TCCCCTAACCA -> CCCCTAACCAT
TCCCGCACCGC -> CCCGCACCGCC
TCCCGGTGATC -> CCCGGTGATCA
TCCCGTGATAA -> CCCGTGATAAG
TCCCTGTACAC -> CCCTGTACACT
TCCCTTCACAT -> CCCTTCACATG
TCCGACCGGAC -> CCGACCGGACA
TCCGCCCTTTT -> CCGCCCTTTTT
TCCGGCGATGC -> CCGGCGATGCT
TCCGGTTCTAG -> CCGGTTCTAGG
TCCTAAAAGTA -> CCTAAAAGTAT
TCCTATACCCG -> CCTATACCCGA
TCCTATACCTA -> CCTATACCTAC
TCCTCCTTGGA -> CCTCCTTGGAT
TCCTTCGGACG -> CCTTCGGACGT
TCCTTCTTCAC -> CCTTCTTCACA
TCCTTGGATGT -> CCTTGGATGTG
TCGACACATGC -> CGACACATGCC
TCGACCGCAGC -> CGACCGCAGCA
TCGACGAGTCA -> CGACGAGTCAC
TCGAGACCACA -> CGAGACCACAA
TCGATCACCTG -> CGATCACCTGT
TCGCCTCTCTC -> CGCCTCTCTCA
TCGCGGTGATC -> CGCGGTGATCG
TCGCGTCCACT -> CGCGTCCACTT
TCGCTACCCCT -> CGCTACCCCTC
TCGCTCCTTCG -> CGCTCCTTCGG
TCGGAACCCAG -> CGGAACCCAGT
TCGGACGTAAC -> CGGACGTAACC
TCGGATACTAA -> CGGATACTAAA
TCGGATCAGTT -> CGGATCAGTTA
TCGGATTTGAT -> CGGATTTGATC
TCGGCTGAGCA -> CGGCTGAGCAC
TCGGCTGTAGG -> CGGCTGTAGGT
TCGGCTTAACC -> CGGCTTAACCC
TCGGGCAAAGA -> CGGGCAAAGAA
TCGGGCCTCCT -> CGGGCCTCCTA
TCGGGGATATA -> CGGGGATATAC
TCGGGTACACT -> CGGGTACACTA
TCGGGTACCAA -> CGGGTACCAAT
TCGTAACCTCA -> CGTAACCTCAA
TCGTAGGTTGT -> CGTAGGTTGTC
TCGTCCACAGA -> CGTCCACAGAG
TCGTCCAGCGC -> CGTCCAGCGCC
TCGTGCTTTCA -> CGTGCTTTCAT
TCGTTGCTGTG -> CGTTGCTGTGA
TCTAACACCGT -> CTAACACCGTC
TCTAATACTCA -> CTAATACTCAA
TCTAATATACA -> CTAATATACAT
TCTACTGTGAT -> CTACTGTGATC
TCTAGGACCAA -> CTAGGACCAAT
TCTAGTCCAAA -> CTAGTCCAAAA
TCTAGTGAAGA -> CTAGTGAAGAG
TCTCACCGGCG -> CTCACCGGCGA
TCTCAGAACGG -> CTCAGAACGGC
TCTCATGTGCC -> CTCATGTGCCG
TCTCCATATAG -> CTCCATATAGG
TCTCCGGTTCT -> CTCCGGTTCTA
TCTCGGATCAG -> CTCGGATCAGT
TCTCTCAGAAC -> CTCTCAGAACG
TCTGCCCGAGG -> CTGCCCGAGGG
TCTTATTACTA -> CTTATTACTAG
TCTTCACAATA -> CTTCACAATAT
TCTTCATCGTG -> CTTCATCGTGC
TCTTGGCCGAG -> CTTGGCCGAGG
TCTTTAAAGAC -> CTTTAAAGACA
TCTTTTGTATT -> CTTTTGTATTT
TGAAATACTCG -> GAAATACTCGT
TGAAATTAAAA -> GAAATTAAAAC
TGAACTGGGGA -> GAACTGGGGAG
TGAAGAGACTG -> GAAGAGACTGT
TGAAGTGCGAA -> GAAGTGCGAAG
TGAATTCAACA -> GAATTCAACAT
TGACCAGATGC -> GACCAGATGCC
TGACCCGAGTT -> GACCCGAGTTC
TGACGGGCTTT -> GACGGGCTTTA
TGACTTGGTAA -> GACTTGGTAAA
TGAGAATAAGC -> GAGAATAAGCA
TGAGACAATCC -> GAGACAATCCA
TGAGAGCTCAG -> GAGAGCTCAGA
TGAGCACGGAT -> GAGCACGGATA
TGAGCGCTTGC -> GAGCGCTTGCT
TGAGGACCCAC -> GAGGACCCACA
TGAGTAACGTG -> GAGTAACGTGC
TGATAAGCCGC -> GATAAGCCGCT
TGATAGTGCTC -> GATAGTGCTCG
TGATATTTAGG -> GATATTTAGGA
TGATCAATTCG -> GATCAATTCGC
TGATCGACACA -> GATCGACACAT
TGATCGTCCAC -> GATCGTCCACA
TGATCTCCATA -> GATCTCCATAT
TGATGCTCAAC -> GATGCTCAACC
TGATGGGTCGC -> GATGGGTCGCG
TGATTAACACC -> GATTAACACCA
TGCAAAAAGGC -> GCAAAAAGGCG
TGCAATTAAGG -> GCAATTAAGGT
TGCACAGACGG -> GCACAGACGGA
TGCACCGCCTC -> GCACCGCCTCG
TGCATAGAAGA -> GCATAGAAGAA
TGCATCCGCCC -> GCATCCGCCCT
TGCATTTGGCC -> GCATTTGGCCC
TGCATTTGTCT -> GCATTTGTCTC
TGCCACTACGT -> GCCACTACGTC
TGCCAGAAAAC -> GCCAGAAAACG
TGCCCGAGGGC -> GCCCGAGGGCA
TGCCCTTATTG -> GCCCTTATTGT
TGCCGATGACT -> GCCGATGACTT
TGCCGTTGCTT -> GCCGTTGCTTG
TGCGAAGCCCG -> GCGAAGCCCGA
TGCGCAACTCC -> GCGCAACTCCT
TGCGCTGACGG -> GCGCTGACGGG
TGCGGCGAAAA -> GCGGCGAAAAC
TGCTAAGCTAC -> GCTAAGCTACT
TGCTACATGAA -> GCTACATGAAT
TGCTATATAGG -> GCTATATAGGC
TGCTCAACCAT -> GCTCAACCATT
TGCTCCGGCGA -> GCTCCGGCGAT
TGCTCGGCTGA -> GCTCGGCTGAG
TGCTCGGGGAT -> GCTCGGGGATA
TGCTCGTAACC -> GCTCGTAACCT
TGCTGTGAAGT -> GCTGTGAAGTG
TGCTTGAAATT -> GCTTGAAATTA
TGCTTGTTTCC -> GCTTGTTTCCC
TGCTTTCATAT -> GCTTTCATATT
TGCTTTTAATG -> GCTTTTAATGG
TGGAAACCCCT -> GGAAACCCCTA
TGGAATACCAC -> GGAATACCACG
TGGATCATTGC -> GGATCATTGCA
TGGATGTGTGA -> GGATGTGTGAT
TGGATTTGCGG -> GGATTTGCGGC
TGGCCCGTCGT -> GGCCCGTCGTA
TGGCCGAGGTG -> GGCCGAGGTGA
TGGCCGCAGGG -> GGCCGCAGGGC
TGGCCTGGAAA -> GGCCTGGAAAC
TGGCGCCCAAT -> GGCGCCCAATT
TGGCTCCTATA -> GGCTCCTATAC
TGGGCCACGAG -> GGGCCACGAGG
TGGGCGCCATT -> GGGCGCCATTG
TGGGGAGGGAC -> GGGGAGGGACA
TGGGTAGAGTG -> GGGTAGAGTGT
TGGGTCGCGGT -> GGGTCGCGGTG
TGGTAAAGGAC -> GGTAAAGGACT
TGGTATGAACT -> GGTATGAACTG
TGGTCATGCAC -> GGTCATGCACC
TGGTCCTAAAA -> GGTCCTAAAAG
TGGTCTTCATC -> GGTCTTCATCG
TGGTTAACTCC -> GGTTAACTCCG
TGGTTGGATTT -> GGTTGGATTTG
TGTACACTGTC -> GTACACTGTCA
TGTACACTTAG -> GTACACTTAGC
TGTACGTGTCC -> GTACGTGTCCA
TGTAGGCCTTC -> GTAGGCCTTCC
TGTAGGCGGCC -> GTAGGCGGCCA
TGTAGGTTTGC -> GTAGGTTTGCA
TGTATTTCATC -> GTATTTCATCG
TGTCAACGGCG -> GTCAACGGCGG
TGTCAGACGTC -> GTCAGACGTCG
TGTCAGATTCG -> GTCAGATTCGG
TGTCCACCAGG -> GTCCACCAGGG
TGTCTCATGTG -> GTCTCATGTGC
TGTCTGCCCGA -> GTCTGCCCGAG
TGTCTTGGCCG -> GTCTTGGCCGA
TGTGAAATACT -> GTGAAATACTC
TGTGAAGTGCG -> GTGAAGTGCGA
TGTGACCCGAG -> GTGACCCGAGT
TGTGAGCGCTT -> GTGAGCGCTTG
TGTGATCGTCC -> GTGATCGTCCA
TGTGATGGGTC -> GTGATGGGTCG
TGTGCATCCGC -> GTGCATCCGCC
TGTGCCGTTGC -> GTGCCGTTGCT
TGTGGTTGGAT -> GTGGTTGGATT
TGTGTAGGCGG -> GTGTAGGCGGC
TGTGTGATGGG -> GTGTGATGGGT
TGTGTGTAGGC -> GTGTGTAGGCG
TGTTGGTTAAC -> GTTGGTTAACT
TGTTTAGCCAC -> GTTTAGCCACA
TGTTTCACTTA -> GTTTCACTTAT
TGTTTCCCGCA -> GTTTCCCGCAC
TTAAAACATTT -> TAAAACATTTC
TTAAACAGTAT -> TAAACAGTATA
TTAAAGACAAT -> TAAAGACAATA
TTAACACCATG -> TAACACCATGA
TTAACACTGGA -> TAACACTGGAT
TTAACCCTCGC -> TAACCCTCGCT
TTAACTCCGAC -> TAACTCCGACC
TTAACTTCAAT -> TAACTTCAATA
TTAAGGTGCTT -> TAAGGTGCTTT
TTAATGGCCTG -> TAATGGCCTGG
TTAATGTGCAT -> TAATGTGCATC
TTACAAAGTCC -> TACAAAGTCCC
TTACAGGAGGT -> TACAGGAGGTT
TTACCGACAGG -> TACCGACAGGA
TTACCGGGCGA -> TACCGGGCGAA
TTACCTACATG -> TACCTACATGC
TTACTAGAATA -> TACTAGAATAA
TTACTGCATTT -> TACTGCATTTG
TTACTTTGACC -> TACTTTGACCA
TTAGAGATTAC -> TAGAGATTACA
TTAGAGGGCGG -> TAGAGGGCGGT
TTAGCCACATG -> TAGCCACATGA
TTAGCCAGACC -> TAGCCAGACCC
TTAGCTACTAG -> TAGCTACTAGG
TTAGCTTCCAT -> TAGCTTCCATC
TTAGGACATTC -> TAGGACATTCT
TTATATAAAGC -> TATATAAAGCG
TTATCCCCTAA -> TATCCCCTAAC
TTATCCCGTGA -> TATCCCGTGAT
TTATCGTCCAG -> TATCGTCCAGC
TTATTACTAGA -> TATTACTAGAA
TTATTGTGTGT -> TATTGTGTGTA
TTATTTGTACG -> TATTTGTACGT
TTCAAAGGCAG -> TCAAAGGCAGG
TTCAACATTAC -> TCAACATTACC
TTCAACGTAGT -> TCAACGTAGTT
TTCAATATTGT -> TCAATATTGTG
TTCACAATATT -> TCACAATATTA
TTCACATGGCT -> TCACATGGCTC
TTCACTTATCC -> TCACTTATCCC
TTCAGCACTAA -> TCAGCACTAAT
TTCATATTGTG -> TCATATTGTGA
TTCATCGGATA -> TCATCGGATAC
TTCATCGTGCT -> TCATCGTGCTT
TTCCATCGATC -> TCCATCGATCA
TTCCATTTGCG -> TCCATTTGCGC
TTCCCGCACCG -> TCCCGCACCGC
TTCCCTTCACA -> TCCCTTCACAT
TTCCTTCTTCA -> TCCTTCTTCAC
TTCGCCTCTCT -> TCGCCTCTCTC
TTCGCTCCTTC -> TCGCTCCTTCG
TTCGGAACCCA -> TCGGAACCCAG
TTCGGACGTAA -> TCGGACGTAAC
TTCGGCTGTAG -> TCGGCTGTAGG
TTCGGGCCTCC -> TCGGGCCTCCT
TTCTAGGACCA -> TCTAGGACCAA
TTCTAGTCCAA -> TCTAGTCCAAA
TTCTAGTGAAG -> TCTAGTGAAGA
TTCTCGGATCA -> TCTCGGATCAG
TTCTTCACAAT -> TCTTCACAATA
TTGAAATTAAA -> TGAAATTAAAA
TTGACCAGATG -> TGACCAGATGC
TTGAGGACCCA -> TGAGGACCCAC
TTGAGTAACGT -> TGAGTAACGTG
TTGATAGTGCT -> TGATAGTGCTC
TTGATATTTAG -> TGATATTTAGG
TTGATCTCCAT -> TGATCTCCATA
TTGCAAAAAGG -> TGCAAAAAGGC
TTGCAATTAAG -> TGCAATTAAGG
TTGCCCTTATT -> TGCCCTTATTG
TTGCGCAACTC -> TGCGCAACTCC
TTGCGGCGAAA -> TGCGGCGAAAA
TTGCTAAGCTA -> TGCTAAGCTAC
TTGCTCCGGCG -> TGCTCCGGCGA
TTGCTGTGAAG -> TGCTGTGAAGT
TTGCTTGAAAT -> TGCTTGAAATT
TTGGAATACCA -> TGGAATACCAC
TTGGATGTGTG -> TGGATGTGTGA
TTGGATTTGCG -> TGGATTTGCGG
TTGGCCCGTCG -> TGGCCCGTCGT
TTGGCCGAGGT -> TGGCCGAGGTG
TTGGGCGCCAT -> TGGGCGCCATT
TTGGGTAGAGT -> TGGGTAGAGTG
TTGGTAAAGGA -> TGGTAAAGGAC
TTGGTTAACTC -> TGGTTAACTCC
TTGTACGTGTC -> TGTACGTGTCC
TTGTATTTCAT -> TGTATTTCATC
TTGTCAGACGT -> TGTCAGACGTC
TTGTCTCATGT -> TGTCTCATGTG
TTGTCTTGGCC -> TGTCTTGGCCG
TTGTGAAATAC -> TGTGAAATACT
TTGTGACCCGA -> TGTGACCCGAG
TTGTGTGTAGG -> TGTGTGTAGGC
TTGTTTCCCGC -> TGTTTCCCGCA
TTTAAACAGTA -> TTAAACAGTAT
TTTAAAGACAA -> TTAAAGACAAT
TTTAATGGCCT -> TTAATGGCCTG
TTTAATGTGCA -> TTAATGTGCAT
TTTACTGCATT -> TTACTGCATTT
TTTAGAGATTA -> TTAGAGATTAC
TTTAGCCACAT -> TTAGCCACATG
TTTAGCTTCCA -> TTAGCTTCCAT
TTTAGGACATT -> TTAGGACATTC
TTTCACTTATC -> TTCACTTATCC
TTTCATATTGT -> TTCATATTGTG
TTTCATCGGAT -> TTCATCGGATA
TTTCCCGCACC -> TTCCCGCACCG
TTTCCCTTCAC -> TTCCCTTCACA
TTTCCTTCTTC -> TTCCTTCTTCA
TTTCGGCTGTA -> TTCGGCTGTAG
TTTGACCAGAT -> TTGACCAGATG
TTTGAGTAACG -> TTGAGTAACGT
TTTGATCTCCA -> TTGATCTCCAT
TTTGCAATTAA -> TTGCAATTAAG
TTTGCGCAACT -> TTGCGCAACTC
TTTGCGGCGAA -> TTGCGGCGAAA
TTTGGCCCGTC -> TTGGCCCGTCG
TTTGTACGTGT -> TTGTACGTGTC
TTTGTATTTCA -> TTGTATTTCAT
TTTGTCTCATG -> TTGTCTCATGT
TTTGTCTTGGC -> TTGTCTTGGCC
TTTTAATGGCC -> TTTAATGGCCT
TTTTAATGTGC -> TTTAATGTGCA
TTTTAGAGATT -> TTTAGAGATTA
TTTTCCCTTCA -> TTTCCCTTCAC
TTTTCCTTCTT -> TTTCCTTCTTC
TTTTGAGTAAC -> TTTGAGTAACG
TTTTGTATTTC -> TTTGTATTTCA
TTTTTCCTTCT -> TTTTCCTTCTT
TTTTTGAGTAA -> TTTTGAGTAAC
