AAAACACGAACGAGCAAGA -> AAACACGAACGAGCAAGAC
AAACACCCCACTTGTTAAG -> AACACCCCACTTGTTAAGT
AAACACGAACGAGCAAGAC -> AACACGAACGAGCAAGACA
AAACAGAACATCAGAACGG -> AACAGAACATCAGAACGGG
AAACGCCATCGTCAGGCAT -> AACGCCATCGTCAGGCATG
AAACGTACCACAGGTCTAC -> AACGTACCACAGGTCTACG
AAACTAGTGTCGCGAAGTT -> AACTAGTGTCGCGAAGTTC
AAACTGGGTAAGGTCCTAT -> AACTGGGTAAGGTCCTATT
AAACTTAAGGACTTCAGGA -> AACTTAAGGACTTCAGGAG
AAAGATTCTACAAGTTGAG -> AAGATTCTACAAGTTGAGG
AAAGCTAGGACCATCCAAG -> AAGCTAGGACCATCCAAGC
AAAGCTGCGTAGATAGCAT -> AAGCTGCGTAGATAGCATT
AAAGGACCCTCTGGATGCA -> AAGGACCCTCTGGATGCAG
AAAGGGTGAGTACCACTTT -> AAGGGTGAGTACCACTTTG
AAATACGAACCCAGCTGGC -> AATACGAACCCAGCTGGCA
AACAATTGGAAAACACGAA -> ACAATTGGAAAACACGAAC
AACACACACGAACTTCAAA -> ACACACACGAACTTCAAAT
AACACCCCACTTGTTAAGT -> ACACCCCACTTGTTAAGTA
AACACCGGACAAGAGATGT -> ACACCGGACAAGAGATGTA
AACACGAACGAGCAAGACA -> ACACGAACGAGCAAGACAC
AACAGAACATCAGAACGGG -> ACAGAACATCAGAACGGGA
AACAGACAGGCTGTTGACG -> ACAGACAGGCTGTTGACGC
AACAGAGGTGGGTATACTG -> ACAGAGGTGGGTATACTGA
AACAGGTATCACCCGAGCT -> ACAGGTATCACCCGAGCTT
AACAGTCAAACACCCCACT -> ACAGTCAAACACCCCACTT
AACATAAGAAGTCTTGCGG -> ACATAAGAAGTCTTGCGGA
AACATCAGAACGGGATTTC -> ACATCAGAACGGGATTTCG
AACCCAGCTGGCATGAACA -> ACCCAGCTGGCATGAACAC
AACCCAGGGGCCTGTGTCT -> ACCCAGGGGCCTGTGTCTT
AACCCGCCATCTCAAGAAG -> ACCCGCCATCTCAAGAAGT
AACCCTATTTCACCAGGGC -> ACCCTATTTCACCAGGGCG
AACCGTGGACCGGCCGAAT -> ACCGTGGACCGGCCGAATG
AACGAACGCACAGCAGGAC -> ACGAACGCACAGCAGGACC
AACGACCTGAGAGATGTTC -> ACGACCTGAGAGATGTTCC
AACGACTCATAATGCCAGT -> ACGACTCATAATGCCAGTT
AACGAGCAAGACACTCTTG -> ACGAGCAAGACACTCTTGT
AACGCACAGCAGGACCCAG -> ACGCACAGCAGGACCCAGG
AACGCAGCCCGTAGACGAT -> ACGCAGCCCGTAGACGATA
AACGCCATCGTCAGGCATG -> ACGCCATCGTCAGGCATGG
AACGCCCCTACGCCAGTAA -> ACGCCCCTACGCCAGTAAG
AACGGCAGTCCTGCCGTAA -> ACGGCAGTCCTGCCGTAAG
AACGGGATTTCGGCGGGGC -> ACGGGATTTCGGCGGGGCC
AACGTAATAATCCGAGGTG -> ACGTAATAATCCGAGGTGT
AACGTACCACAGGTCTACG -> ACGTACCACAGGTCTACGT
AACGTGCGGTATTCGAATT -> ACGTGCGGTATTCGAATTG
AACGTGCTAGGTCAGGTGA -> ACGTGCTAGGTCAGGTGAA
AACTAGTGTCGCGAAGTTC -> ACTAGTGTCGCGAAGTTCT
AACTGGGTAAGGTCCTATT -> ACTGGGTAAGGTCCTATTC
AACTTAAGGACTTCAGGAG -> ACTTAAGGACTTCAGGAGG
AACTTCAAATACGAACCCA -> ACTTCAAATACGAACCCAG
AACTTCCGTCAGAACTTTG -> ACTTCCGTCAGAACTTTGG
AACTTTGGACGATATGAAC -> ACTTTGGACGATATGAACA
AAGAAGTACAAGCTTGCTT -> AGAAGTACAAGCTTGCTTG
AAGAAGTCTTGCGGAGCTG -> AGAAGTCTTGCGGAGCTGT
AAGAATTTCTCTTTTTCTG -> AGAATTTCTCTTTTTCTGT
AAGACACTCTTGTTTCCAC -> AGACACTCTTGTTTCCACT
AAGACAGACATGACCTTAA -> AGACAGACATGACCTTAAT
AAGACATGTAGAGCGGTGA -> AGACATGTAGAGCGGTGAC
AAGAGATGTATGTAAGTAG -> AGAGATGTATGTAAGTAGC
AAGATATCACATTGTGGGC -> AGATATCACATTGTGGGCG
AAGATTCTACAAGTTGAGG -> AGATTCTACAAGTTGAGGG
AAGCAACCCAGGGGCCTGT -> AGCAACCCAGGGGCCTGTG
AAGCACATGGCTTATTTAC -> AGCACATGGCTTATTTACA
AAGCAGCATGTCACCGGAC -> AGCAGCATGTCACCGGACA
AAGCAGCCGATTCTGTGCA -> AGCAGCCGATTCTGTGCAT
AAGCCTTGGCAGGTACACC -> AGCCTTGGCAGGTACACCT
AAGCGATGTACAAACTTAA -> AGCGATGTACAAACTTAAG
AAGCGGACTTGTCATGCGC -> AGCGGACTTGTCATGCGCA
AAGCTAGGACCATCCAAGC -> AGCTAGGACCATCCAAGCA
AAGCTGCGTAGATAGCATT -> AGCTGCGTAGATAGCATTG
AAGCTTGCTTGCGAACCCT -> AGCTTGCTTGCGAACCCTA
AAGGACCCTCTGGATGCAG -> AGGACCCTCTGGATGCAGT
AAGGACTTCAGGAGGATCG -> AGGACTTCAGGAGGATCGC
AAGGCCCGCGTCTCCACCT -> AGGCCCGCGTCTCCACCTT
AAGGGAGTCGCCACATTCT -> AGGGAGTCGCCACATTCTT
AAGGGTGAGTACCACTTTG -> AGGGTGAGTACCACTTTGC
AAGGGTGATTACATAGCGC -> AGGGTGATTACATAGCGCG
AAGGTCCTATTCGATTTGA -> AGGTCCTATTCGATTTGAA
AAGGTTGGTCAGGACGGGC -> AGGTTGGTCAGGACGGGCA
AAGTAACGGCAGTCCTGCC -> AGTAACGGCAGTCCTGCCG
AAGTACAAGCTTGCTTGCG -> AGTACAAGCTTGCTTGCGA
AAGTACAGTCGCCCCGTTG -> AGTACAGTCGCCCCGTTGC
AAGTAGCTAGCAATCTATG -> AGTAGCTAGCAATCTATGC
AAGTAGCTAGCAATCTCAT -> AGTAGCTAGCAATCTCATA
AAGTAGCTAGCAATCTGTT -> AGTAGCTAGCAATCTGTTG
AAGTAGCTAGCAATCTTGG -> AGTAGCTAGCAATCTTGGT
AAGTCTGAACGCCCCTACG -> AGTCTGAACGCCCCTACGC
AAGTCTTGCGGAGCTGTGA -> AGTCTTGCGGAGCTGTGAG
AAGTTCTAGCCCTCAGCGC -> AGTTCTAGCCCTCAGCGCA
AAGTTGAGGGGCTACTACT -> AGTTGAGGGGCTACTACTA
AATAAGACAGACATGACCT -> ATAAGACAGACATGACCTT
AATAAGCGGACTTGTCATG -> ATAAGCGGACTTGTCATGC
AATAATCCGAGGTGTAATG -> ATAATCCGAGGTGTAATGG
AATAATCCGAGGTGTCAGA -> ATAATCCGAGGTGTCAGAC
AATAATCCGAGGTGTCCTA -> ATAATCCGAGGTGTCCTAT
AATAATCCGAGGTGTGACT -> ATAATCCGAGGTGTGACTT
AATACGAACCCAGCTGGCA -> ATACGAACCCAGCTGGCAT
AATACGTCAACAGGTATCA -> ATACGTCAACAGGTATCAC
AATAGAGGTGAATTAATTT -> ATAGAGGTGAATTAATTTA
AATATCGGCATTTGAACAT -> ATATCGGCATTTGAACATA
AATATCTACGTGCACGGTG -> ATATCTACGTGCACGGTGA
AATCAGCAGAAACGCCATC -> ATCAGCAGAAACGCCATCG
AATCATTACAAGGGTGATT -> ATCATTACAAGGGTGATTA
AATCCGAGGTGTAATGGAG -> ATCCGAGGTGTAATGGAGA
AATCCGAGGTGTCAGACCC -> ATCCGAGGTGTCAGACCCG
AATCCGAGGTGTCCTATAC -> ATCCGAGGTGTCCTATACG
AATCCGAGGTGTGACTTTT -> ATCCGAGGTGTGACTTTTT
AATCTATGCCCAGACAACG -> ATCTATGCCCAGACAACGT
AATCTCATATCGGGACACG -> ATCTCATATCGGGACACGT
AATCTGTTGCCCTCGGACG -> ATCTGTTGCCCTCGGACGT
AATCTTCCCATCAAAGATT -> ATCTTCCCATCAAAGATTC
AATCTTGGTATATCTCACG -> ATCTTGGTATATCTCACGT
AATGCCAGTTACTCGTCGT -> ATGCCAGTTACTCGTCGTT
AATGCCCCTGTTCGGATGC -> ATGCCCCTGTTCGGATGCC
AATGGAGACAAACGTACCA -> ATGGAGACAAACGTACCAC
AATGTACGACGCGATAGCA -> ATGTACGACGCGATAGCAC
AATGTATCCGACTTTACCC -> ATGTATCCGACTTTACCCA
AATGTGGAGATATGGCACC -> ATGTGGAGATATGGCACCA
AATTAATCAGCAGAAACGC -> ATTAATCAGCAGAAACGCC
AATTAATTTAATATCGGCA -> ATTAATTTAATATCGGCAT
AATTGGAAAACACGAACGA -> ATTGGAAAACACGAACGAG
AATTGGTCTCAAGGCCCGC -> ATTGGTCTCAAGGCCCGCG
AATTTAATATCGGCATTTG -> ATTTAATATCGGCATTTGA
AATTTCTCTTTTTCTGTGC -> ATTTCTCTTTTTCTGTGCT
ACAAACGTACCACAGGTCT -> CAAACGTACCACAGGTCTA
ACAAACTTAAGGACTTCAG -> CAAACTTAAGGACTTCAGG
ACAACAGACAGGCTGTTGA -> CAACAGACAGGCTGTTGAC
ACAACGTAATAATCCGAGG -> CAACGTAATAATCCGAGGT
ACAACGTGCTAGGTCAGGT -> CAACGTGCTAGGTCAGGTG
ACAAGAGATGTATGTAAGT -> CAAGAGATGTATGTAAGTA
ACAAGCTTGCTTGCGAACC -> CAAGCTTGCTTGCGAACCC
ACAAGGGTGATTACATAGC -> CAAGGGTGATTACATAGCG
ACAAGTTGAGGGGCTACTA -> CAAGTTGAGGGGCTACTAC
ACAATAAGACAGACATGAC -> CAATAAGACAGACATGACC
ACAATTGGAAAACACGAAC -> CAATTGGAAAACACGAACG
ACACACACGAACTTCAAAT -> CACACACGAACTTCAAATA
ACACACGAACTTCAAATAC -> CACACGAACTTCAAATACG
ACACAGTGGGTACAACAGA -> CACAGTGGGTACAACAGAC
ACACCCCACTTGTTAAGTA -> CACCCCACTTGTTAAGTAC
ACACCCGTTTGACCACGCT -> CACCCGTTTGACCACGCTT
ACACCGGACAAGAGATGTA -> CACCGGACAAGAGATGTAT
ACACCTGATCACTACTTTC -> CACCTGATCACTACTTTCG
ACACGAACGAGCAAGACAC -> CACGAACGAGCAAGACACT
ACACGAACTTCAAATACGA -> CACGAACTTCAAATACGAA
ACACGCGGTGAATGTGGAG -> CACGCGGTGAATGTGGAGA
ACACGTAATAATCCGAGGT -> CACGTAATAATCCGAGGTG
ACACTCTTGTTTCCACTTA -> CACTCTTGTTTCCACTTAA
ACAGAACATCAGAACGGGA -> CAGAACATCAGAACGGGAT
ACAGACAGGCTGTTGACGC -> CAGACAGGCTGTTGACGCA
ACAGACATGACCTTAATAC -> CAGACATGACCTTAATACG
ACAGAGGTGGGTATACTGA -> CAGAGGTGGGTATACTGAT
ACAGCAGCAAACAGAACAT -> CAGCAGCAAACAGAACATC
ACAGCAGGACCCAGGAGAC -> CAGCAGGACCCAGGAGACC
ACAGCGGCAAGTCTGAACG -> CAGCGGCAAGTCTGAACGC
ACAGGCTGTTGACGCACGA -> CAGGCTGTTGACGCACGAG
ACAGGTATCACCCGAGCTT -> CAGGTATCACCCGAGCTTC
ACAGGTCTACGTGGGTTCG -> CAGGTCTACGTGGGTTCGT
ACAGTCAAACACCCCACTT -> CAGTCAAACACCCCACTTG
ACAGTCGCCCCGTTGCCAG -> CAGTCGCCCCGTTGCCAGG
ACAGTGGGTACAACAGACA -> CAGTGGGTACAACAGACAG
ACATAAGAAGTCTTGCGGA -> CATAAGAAGTCTTGCGGAG
ACATAGCGCGAAAGCTAGG -> CATAGCGCGAAAGCTAGGA
ACATCAGAACGGGATTTCG -> CATCAGAACGGGATTTCGG
ACATGACCTTAATACGTCA -> CATGACCTTAATACGTCAA
ACATGGCTTATTTACAATA -> CATGGCTTATTTACAATAA
ACATGTAGAGCGGTGACGC -> CATGTAGAGCGGTGACGCC
ACATTCTTCCTCGTTAGTC -> CATTCTTCCTCGTTAGTCT
ACATTGTGGGCGAGTTAGT -> CATTGTGGGCGAGTTAGTC
ACATTTACGAGTCTTAAGG -> CATTTACGAGTCTTAAGGG
ACCAACAGAGGTGGGTATA -> CCAACAGAGGTGGGTATAC
ACCACAGGTCTACGTGGGT -> CCACAGGTCTACGTGGGTT
ACCACGCTTTCTCGCGGGT -> CCACGCTTTCTCGCGGGTG
ACCACTTTGCACTGTGACA -> CCACTTTGCACTGTGACAA
ACCAGGGCGGCAATTAATC -> CCAGGGCGGCAATTAATCA
ACCATCCAAGCAGCATGTC -> CCATCCAAGCAGCATGTCA
ACCATGTCACGTGCTTACG -> CCATGTCACGTGCTTACGT
ACCCAGCTGGCATGAACAC -> CCCAGCTGGCATGAACACC
ACCCAGGAGACCATGTCAC -> CCCAGGAGACCATGTCACG
ACCCAGGGGCCTGTGTCTT -> CCCAGGGGCCTGTGTCTTT
ACCCATACAGCAGCAAACA -> CCCATACAGCAGCAAACAG
ACCCCACCCCTAACAATTG -> CCCCACCCCTAACAATTGG
ACCCCACTTGTTAAGTACA -> CCCCACTTGTTAAGTACAG
ACCCCTAACAATTGGAAAA -> CCCCTAACAATTGGAAAAC
ACCCGAGCTTCATTGTCAA -> CCCGAGCTTCATTGTCAAA
ACCCGCATGAAAACTCTAA -> CCCGCATGAAAACTCTAAG
ACCCGCCATCTCAAGAAGT -> CCCGCCATCTCAAGAAGTA
ACCCGGGAGCTCCACTGTG -> CCCGGGAGCTCCACTGTGC
ACCCGTATTTTAATGCCCC -> CCCGTATTTTAATGCCCCT
ACCCGTTTGACCACGCTTT -> CCCGTTTGACCACGCTTTC
ACCCTATCCATCTCACTCT -> CCCTATCCATCTCACTCTT
ACCCTATTTCACCAGGGCG -> CCCTATTTCACCAGGGCGG
ACCCTCTGGATGCAGTAGC -> CCCTCTGGATGCAGTAGCA
ACCGAGTGGCTGCACGCTA -> CCGAGTGGCTGCACGCTAT
ACCGGACAAGAGATGTATG -> CCGGACAAGAGATGTATGT
ACCGGACAGCGGCAAGTCT -> CCGGACAGCGGCAAGTCTG
ACCGGCCGAATGTACGACG -> CCGGCCGAATGTACGACGC
ACCGTATGGGACACAGTGG -> CCGTATGGGACACAGTGGG
ACCGTGGACCGGCCGAATG -> CCGTGGACCGGCCGAATGT
ACCTATTTTAGGCGGAAAG -> CCTATTTTAGGCGGAAAGC
ACCTGAGAGATGTTCCCTA -> CCTGAGAGATGTTCCCTAG
ACCTGATCACTACTTTCGC -> CCTGATCACTACTTTCGCA
ACCTTAATACGTCAACAGG -> CCTTAATACGTCAACAGGT
ACCTTGTGGCGGCAATAAG -> CCTTGTGGCGGCAATAAGC
ACGAACCCAGCTGGCATGA -> CGAACCCAGCTGGCATGAA
ACGAACGAGCAAGACACTC -> CGAACGAGCAAGACACTCT
ACGAACGCACAGCAGGACC -> CGAACGCACAGCAGGACCC
ACGAACTTCAAATACGAAC -> CGAACTTCAAATACGAACC
ACGACATTTACGAGTCTTA -> CGACATTTACGAGTCTTAA
ACGACCTGAGAGATGTTCC -> CGACCTGAGAGATGTTCCC
ACGACGCGATAGCACCCGT -> CGACGCGATAGCACCCGTA
ACGACTCATAATGCCAGTT -> CGACTCATAATGCCAGTTA
ACGAGAGAACGACTCATAA -> CGAGAGAACGACTCATAAT
ACGAGCAAGACACTCTTGT -> CGAGCAAGACACTCTTGTT
ACGAGTCTTAAGGGAGTCG -> CGAGTCTTAAGGGAGTCGC
ACGATATAGGGACTAGATG -> CGATATAGGGACTAGATGG
ACGATATGAACAGTCAAAC -> CGATATGAACAGTCAAACA
ACGATTTCTTTGTGATCTA -> CGATTTCTTTGTGATCTAA
ACGCAAGTAACGGCAGTCC -> CGCAAGTAACGGCAGTCCT
ACGCACAGCAGGACCCAGG -> CGCACAGCAGGACCCAGGA
ACGCACGAGAGAACGACTC -> CGCACGAGAGAACGACTCA
ACGCAGCCCGTAGACGATA -> CGCAGCCCGTAGACGATAT
ACGCCACGACATTTACGAG -> CGCCACGACATTTACGAGT
ACGCCAGTAAGACATGTAG -> CGCCAGTAAGACATGTAGA
ACGCCATCGTCAGGCATGG -> CGCCATCGTCAGGCATGGC
ACGCCATTATCTCCGTGTT -> CGCCATTATCTCCGTGTTC
ACGCCCCTACGCCAGTAAG -> CGCCCCTACGCCAGTAAGA
ACGCGATAGCACCCGTATT -> CGCGATAGCACCCGTATTT
ACGCGGTGAATGTGGAGAT -> CGCGGTGAATGTGGAGATA
ACGCTATAATAGAGGTGAA -> CGCTATAATAGAGGTGAAT
ACGCTTTCTCGCGGGTGAG -> CGCTTTCTCGCGGGTGAGG
ACGGCAGTCCTGCCGTAAG -> CGGCAGTCCTGCCGTAAGT
ACGGGATTTCGGCGGGGCC -> CGGGATTTCGGCGGGGCCG
ACGGGCAGTCCGCATGGCC -> CGGGCAGTCCGCATGGCCG
ACGGGCTCGGGTCTCCTCC -> CGGGCTCGGGTCTCCTCCA
ACGGTGATGCAGTGGACCT -> CGGTGATGCAGTGGACCTA
ACGTAATAATCCGAGGTGT -> CGTAATAATCCGAGGTGTA,CGTAATAATCCGAGGTGTC,CGTAATAATCCGAGGTGTC,CGTAATAATCCGAGGTGTG
ACGTACCACAGGTCTACGT -> CGTACCACAGGTCTACGTG
ACGTCAACAGGTATCACCC -> CGTCAACAGGTATCACCCG
ACGTCTAACGACCTGAGAG -> CGTCTAACGACCTGAGAGA
ACGTCTGGACGTCTAACGA -> CGTCTGGACGTCTAACGAC
ACGTGCACGGTGATGCAGT -> CGTGCACGGTGATGCAGTG
ACGTGCGGTATTCGAATTG -> CGTGCGGTATTCGAATTGG
ACGTGCTAGGTCAGGTGAA -> CGTGCTAGGTCAGGTGAAC
ACGTGCTTACGTCTGGACG -> CGTGCTTACGTCTGGACGT
ACGTGGGTTCGTTCAAGCG -> CGTGGGTTCGTTCAAGCGA
ACTAATGTATCCGACTTTA -> CTAATGTATCCGACTTTAC
ACTACTAATGTATCCGACT -> CTACTAATGTATCCGACTT
ACTACTTTCGCAGGAGGTA -> CTACTTTCGCAGGAGGTAT
ACTAGATGGAGTGCCAATA -> CTAGATGGAGTGCCAATAT
ACTAGTGTCGCGAAGTTCT -> CTAGTGTCGCGAAGTTCTA
ACTCATAATGCCAGTTACT -> CTCATAATGCCAGTTACTC
ACTCGTCGTTGTGGAGGGG -> CTCGTCGTTGTGGAGGGGT
ACTCTTCAGTTGGGCAGAT -> CTCTTCAGTTGGGCAGATT
ACTCTTGTTTCCACTTAAC -> CTCTTGTTTCCACTTAACG
ACTGATACTGCACCGAGTG -> CTGATACTGCACCGAGTGG
ACTGCACCGAGTGGCTGCA -> CTGCACCGAGTGGCTGCAC
ACTGGGTAAGGTCCTATTC -> CTGGGTAAGGTCCTATTCG
ACTGTGACAACGTGCTAGG -> CTGTGACAACGTGCTAGGT
ACTGTGCGATACTTTCATC -> CTGTGCGATACTTTCATCT
ACTTAACGAACGCACAGCA -> CTTAACGAACGCACAGCAG
ACTTAAGGACTTCAGGAGG -> CTTAAGGACTTCAGGAGGA
ACTTATGGACACGCGGTGA -> CTTATGGACACGCGGTGAA
ACTTCAAATACGAACCCAG -> CTTCAAATACGAACCCAGC
ACTTCAGGAGGATCGCTGC -> CTTCAGGAGGATCGCTGCC
ACTTCCGTCAGAACTTTGG -> CTTCCGTCAGAACTTTGGA
ACTTGTCATGCGCACTTAT -> CTTGTCATGCGCACTTATG
ACTTGTTAAGTACAGTCGC -> CTTGTTAAGTACAGTCGCC
ACTTTACCCATACAGCAGC -> CTTTACCCATACAGCAGCA
ACTTTCATCTTCAATCATT -> CTTTCATCTTCAATCATTA
ACTTTCGCAGGAGGTATCT -> CTTTCGCAGGAGGTATCTG
ACTTTGCACTGTGACAACG -> CTTTGCACTGTGACAACGT
ACTTTGGACGATATGAACA -> CTTTGGACGATATGAACAG
ACTTTTTGTCCCACGCCAC -> CTTTTTGTCCCACGCCACG
AGAAACGCCATCGTCAGGC -> GAAACGCCATCGTCAGGCA
AGAACATCAGAACGGGATT -> GAACATCAGAACGGGATTT
AGAACGACTCATAATGCCA -> GAACGACTCATAATGCCAG
AGAACGGGATTTCGGCGGG -> GAACGGGATTTCGGCGGGG
AGAACTTTGGACGATATGA -> GAACTTTGGACGATATGAA
AGAAGAATTTCTCTTTTTC -> GAAGAATTTCTCTTTTTCT
AGAAGTACAAGCTTGCTTG -> GAAGTACAAGCTTGCTTGC
AGAAGTCTTGCGGAGCTGT -> GAAGTCTTGCGGAGCTGTG
AGAATTTCTCTTTTTCTGT -> GAATTTCTCTTTTTCTGTG
AGACAAACGTACCACAGGT -> GACAAACGTACCACAGGTC
AGACAACGTAATAATCCGA -> GACAACGTAATAATCCGAG
AGACACTCTTGTTTCCACT -> GACACTCTTGTTTCCACTT
AGACAGACATGACCTTAAT -> GACAGACATGACCTTAATA
AGACAGGCTGTTGACGCAC -> GACAGGCTGTTGACGCACG
AGACATGACCTTAATACGT -> GACATGACCTTAATACGTC
AGACATGTAGAGCGGTGAC -> GACATGTAGAGCGGTGACG
AGACCATGTCACGTGCTTA -> GACCATGTCACGTGCTTAC
AGACCCGCATGAAAACTCT -> GACCCGCATGAAAACTCTA
AGACCCGGGAGCTCCACTG -> GACCCGGGAGCTCCACTGT
AGACGATATAGGGACTAGA -> GACGATATAGGGACTAGAT
AGAGAACGACTCATAATGC -> GAGAACGACTCATAATGCC
AGAGATGTATGTAAGTAGC -> GAGATGTATGTAAGTAGCT
AGAGATGTTCCCTAGGATC -> GAGATGTTCCCTAGGATCC
AGAGCGGTGACGCCATTAT -> GAGCGGTGACGCCATTATC
AGAGGTGAATTAATTTAAT -> GAGGTGAATTAATTTAATA
AGAGGTGGGTATACTGATA -> GAGGTGGGTATACTGATAC
AGATAGCATTGCTTGAACG -> GATAGCATTGCTTGAACGT
AGATATCACATTGTGGGCG -> GATATCACATTGTGGGCGA
AGATATGGCACCAACAGAG -> GATATGGCACCAACAGAGG
AGATGGAGTGCCAATATCT -> GATGGAGTGCCAATATCTA
AGATGTATGTAAGTAGCTA -> GATGTATGTAAGTAGCTAG
AGATGTTCCCTAGGATCCC -> GATGTTCCCTAGGATCCCT
AGATTCTACAAGTTGAGGG -> GATTCTACAAGTTGAGGGG
AGATTTGCGCAGGGATCAT -> GATTTGCGCAGGGATCATG
AGCAAACAGAACATCAGAA -> GCAAACAGAACATCAGAAC
AGCAACACACACGAACTTC -> GCAACACACACGAACTTCA
AGCAACCCAGGGGCCTGTG -> GCAACCCAGGGGCCTGTGT
AGCAAGACACTCTTGTTTC -> GCAAGACACTCTTGTTTCC
AGCAAGCACATGGCTTATT -> GCAAGCACATGGCTTATTT
AGCAATCTATGCCCAGACA -> GCAATCTATGCCCAGACAA
AGCAATCTCATATCGGGAC -> GCAATCTCATATCGGGACA
AGCAATCTGTTGCCCTCGG -> GCAATCTGTTGCCCTCGGA
AGCAATCTTGGTATATCTC -> GCAATCTTGGTATATCTCA
AGCACATGGCTTATTTACA -> GCACATGGCTTATTTACAA
AGCACCCGTATTTTAATGC -> GCACCCGTATTTTAATGCC
AGCAGAAACGCCATCGTCA -> GCAGAAACGCCATCGTCAG
AGCAGCAAACAGAACATCA -> GCAGCAAACAGAACATCAG
AGCAGCATGTCACCGGACA -> GCAGCATGTCACCGGACAG
AGCAGCCGATTCTGTGCAT -> GCAGCCGATTCTGTGCATC
AGCAGGACCCAGGAGACCA -> GCAGGACCCAGGAGACCAT
AGCATCGCGTAAAGGGTGA -> GCATCGCGTAAAGGGTGAG
AGCATGTCACCGGACAGCG -> GCATGTCACCGGACAGCGG
AGCATTGCTTGAACGTGCG -> GCATTGCTTGAACGTGCGG
AGCCCGTAGACGATATAGG -> GCCCGTAGACGATATAGGG
AGCCCTCAGCGCATCCCCA -> GCCCTCAGCGCATCCCCAA
AGCCGATTCTGTGCATCGT -> GCCGATTCTGTGCATCGTT
AGCCTTGGCAGGTACACCT -> GCCTTGGCAGGTACACCTG
AGCGATGCATGGAGAAGAA -> GCGATGCATGGAGAAGAAT
AGCGATGTACAAACTTAAG -> GCGATGTACAAACTTAAGG
AGCGCATCCCCAACTTCCG -> GCGCATCCCCAACTTCCGT
AGCGCGAAAGCTAGGACCA -> GCGCGAAAGCTAGGACCAT
AGCGCGCGGTCAGCGATGC -> GCGCGCGGTCAGCGATGCA
AGCGGACTTGTCATGCGCA -> GCGGACTTGTCATGCGCAC
AGCGGCAAGTCTGAACGCC -> GCGGCAAGTCTGAACGCCC
AGCGGTGACGCCATTATCT -> GCGGTGACGCCATTATCTC
AGCTAGCAATCTATGCCCA -> GCTAGCAATCTATGCCCAG
AGCTAGCAATCTCATATCG -> GCTAGCAATCTCATATCGG
AGCTAGCAATCTGTTGCCC -> GCTAGCAATCTGTTGCCCT
AGCTAGCAATCTTGGTATA -> GCTAGCAATCTTGGTATAT
AGCTAGGACCATCCAAGCA -> GCTAGGACCATCCAAGCAG
AGCTCCACTGTGCGATACT -> GCTCCACTGTGCGATACTT
AGCTGCGTAGATAGCATTG -> GCTGCGTAGATAGCATTGC
AGCTGGCATGAACACCGGA -> GCTGGCATGAACACCGGAC
AGCTGTGAGTGTGAAGCAG -> GCTGTGAGTGTGAAGCAGC
AGCTTCATTGTCAAACTGG -> GCTTCATTGTCAAACTGGG
AGCTTGCTTGCGAACCCTA -> GCTTGCTTGCGAACCCTAT
AGGACCATCCAAGCAGCAT -> GGACCATCCAAGCAGCATG
AGGACCCAGGAGACCATGT -> GGACCCAGGAGACCATGTC
AGGACCCTCTGGATGCAGT -> GGACCCTCTGGATGCAGTA
AGGACCGTATGGGACACAG -> GGACCGTATGGGACACAGT
AGGACGGGCAGTCCGCATG -> GGACGGGCAGTCCGCATGG
AGGACTTCAGGAGGATCGC -> GGACTTCAGGAGGATCGCT
AGGAGACCATGTCACGTGC -> GGAGACCATGTCACGTGCT
AGGAGGATCGCTGCCAGCA -> GGAGGATCGCTGCCAGCAA
AGGAGGTATCTGTCTGAAC -> GGAGGTATCTGTCTGAACC
AGGAGTAAGTAGCTAGCAA -> GGAGTAAGTAGCTAGCAAT
AGGATCCCTTTCTTGCAGT -> GGATCCCTTTCTTGCAGTA
AGGATCGCTGCCAGCAAGC -> GGATCGCTGCCAGCAAGCA
AGGCATGGCAAGCAACCCA -> GGCATGGCAAGCAACCCAG
AGGCCCGCGTCTCCACCTT -> GGCCCGCGTCTCCACCTTG
AGGCGGAAAGCTGCGTAGA -> GGCGGAAAGCTGCGTAGAT
AGGCTGTTGACGCACGAGA -> GGCTGTTGACGCACGAGAG
AGGGACTAGATGGAGTGCC -> GGGACTAGATGGAGTGCCA
AGGGAGTCGCCACATTCTT -> GGGAGTCGCCACATTCTTC
AGGGATCATGTATGACCCC -> GGGATCATGTATGACCCCA
AGGGATCTCTAGCATCGCG -> GGGATCTCTAGCATCGCGT
AGGGCGGCAATTAATCAGC -> GGGCGGCAATTAATCAGCA
AGGGGCCTGTGTCTTTTGC -> GGGGCCTGTGTCTTTTGCA
AGGGGCTACTACTAATGTA -> GGGGCTACTACTAATGTAT
AGGGGTTAATCTTCCCATC -> GGGGTTAATCTTCCCATCA
AGGGTCGTGCCAAAGGACC -> GGGTCGTGCCAAAGGACCC
AGGGTGAGTACCACTTTGC -> GGGTGAGTACCACTTTGCA
AGGGTGATTACATAGCGCG -> GGGTGATTACATAGCGCGA
AGGTACACCTGATCACTAC -> GGTACACCTGATCACTACT
AGGTAGACCCGCATGAAAA -> GGTAGACCCGCATGAAAAC
AGGTATCACCCGAGCTTCA -> GGTATCACCCGAGCTTCAT
AGGTATCTGTCTGAACCGT -> GGTATCTGTCTGAACCGTG
AGGTCAGGTGAACGCAGCC -> GGTCAGGTGAACGCAGCCC
AGGTCCTATTCGATTTGAA -> GGTCCTATTCGATTTGAAG
AGGTCTACGTGGGTTCGTT -> GGTCTACGTGGGTTCGTTC
AGGTGAACGCAGCCCGTAG -> GGTGAACGCAGCCCGTAGA
AGGTGAATTAATTTAATAT -> GGTGAATTAATTTAATATC
AGGTGGGTATACTGATACT -> GGTGGGTATACTGATACTG
AGGTGTAATGGAGACAAAC -> GGTGTAATGGAGACAAACG
AGGTGTCAGACCCGGGAGC -> GGTGTCAGACCCGGGAGCT
AGGTGTCCTATACGCAAGT -> GGTGTCCTATACGCAAGTA
AGGTGTGACTTTTTGTCCC -> GGTGTGACTTTTTGTCCCA
AGGTTGGTCAGGACGGGCA -> GGTTGGTCAGGACGGGCAG
AGTAACGGCAGTCCTGCCG -> GTAACGGCAGTCCTGCCGT
AGTAAGACATGTAGAGCGG -> GTAAGACATGTAGAGCGGT
AGTAAGTAGCTAGCAATCT -> GTAAGTAGCTAGCAATCTA
AGTACAAGCTTGCTTGCGA -> GTACAAGCTTGCTTGCGAA
AGTACAGTCGCCCCGTTGC -> GTACAGTCGCCCCGTTGCC
AGTACCACTTTGCACTGTG -> GTACCACTTTGCACTGTGA
AGTAGCAACACACACGAAC -> GTAGCAACACACACGAACT
AGTAGCTAGCAATCTATGC -> GTAGCTAGCAATCTATGCC
AGTAGCTAGCAATCTCATA -> GTAGCTAGCAATCTCATAT
AGTAGCTAGCAATCTGTTG -> GTAGCTAGCAATCTGTTGC
AGTAGCTAGCAATCTTGGT -> GTAGCTAGCAATCTTGGTA
AGTATTCTAAGCCTTGGCA -> GTATTCTAAGCCTTGGCAG
AGTCAAACACCCCACTTGT -> GTCAAACACCCCACTTGTT
AGTCCGCATGGCCGGGCAC -> GTCCGCATGGCCGGGCACA
AGTCCTGCCGTAAGTAGCT -> GTCCTGCCGTAAGTAGCTA
AGTCGCCACATTCTTCCTC -> GTCGCCACATTCTTCCTCG
AGTCGCCCCGTTGCCAGGA -> GTCGCCCCGTTGCCAGGAG
AGTCGGTTGAACCCGCCAT -> GTCGGTTGAACCCGCCATC
AGTCTGAACGCCCCTACGC -> GTCTGAACGCCCCTACGCC
AGTCTGAGGGATCTCTAGC -> GTCTGAGGGATCTCTAGCA
AGTCTTAAGGGAGTCGCCA -> GTCTTAAGGGAGTCGCCAC
AGTCTTGCGGAGCTGTGAG -> GTCTTGCGGAGCTGTGAGT
AGTGCCAATATCTACGTGC -> GTGCCAATATCTACGTGCA
AGTGGACCTATTTTAGGCG -> GTGGACCTATTTTAGGCGG
AGTGGCTGCACGCTATAAT -> GTGGCTGCACGCTATAATA
AGTGGGTACAACAGACAGG -> GTGGGTACAACAGACAGGC
AGTGTCGCGAAGTTCTAGC -> GTGTCGCGAAGTTCTAGCC
AGTGTGAAGCAGCCGATTC -> GTGTGAAGCAGCCGATTCT
AGTTACTCGTCGTTGTGGA -> GTTACTCGTCGTTGTGGAG
AGTTAGTCGGTTGAACCCG -> GTTAGTCGGTTGAACCCGC
AGTTCTAGCCCTCAGCGCA -> GTTCTAGCCCTCAGCGCAT
AGTTGAGGGGCTACTACTA -> GTTGAGGGGCTACTACTAA
AGTTGGGCAGATTTGCGCA -> GTTGGGCAGATTTGCGCAG
ATAAGAAGTCTTGCGGAGC -> TAAGAAGTCTTGCGGAGCT
ATAAGACAGACATGACCTT -> TAAGACAGACATGACCTTA
ATAAGCGGACTTGTCATGC -> TAAGCGGACTTGTCATGCG
ATAATAGAGGTGAATTAAT -> TAATAGAGGTGAATTAATT
ATAATCCGAGGTGTAATGG -> TAATCCGAGGTGTAATGGA
ATAATCCGAGGTGTCAGAC -> TAATCCGAGGTGTCAGACC
ATAATCCGAGGTGTCCTAT -> TAATCCGAGGTGTCCTATA
ATAATCCGAGGTGTGACTT -> TAATCCGAGGTGTGACTTT
ATAATGCCAGTTACTCGTC -> TAATGCCAGTTACTCGTCG
ATACAGCAGCAAACAGAAC -> TACAGCAGCAAACAGAACA
ATACGAACCCAGCTGGCAT -> TACGAACCCAGCTGGCATG
ATACGCAAGTAACGGCAGT -> TACGCAAGTAACGGCAGTC
ATACGGGCTCGGGTCTCCT -> TACGGGCTCGGGTCTCCTC
ATACGTCAACAGGTATCAC -> TACGTCAACAGGTATCACC
ATACTGATACTGCACCGAG -> TACTGATACTGCACCGAGT
ATACTGCACCGAGTGGCTG -> TACTGCACCGAGTGGCTGC
ATACTTTCATCTTCAATCA -> TACTTTCATCTTCAATCAT
ATAGAGGTGAATTAATTTA -> TAGAGGTGAATTAATTTAA
ATAGCACCCGTATTTTAAT -> TAGCACCCGTATTTTAATG
ATAGCATTGCTTGAACGTG -> TAGCATTGCTTGAACGTGC
ATAGCGCGAAAGCTAGGAC -> TAGCGCGAAAGCTAGGACC
ATAGGGACTAGATGGAGTG -> TAGGGACTAGATGGAGTGC
ATATAGGGACTAGATGGAG -> TATAGGGACTAGATGGAGT
ATATCACATTGTGGGCGAG -> TATCACATTGTGGGCGAGT
ATATCGGCATTTGAACATA -> TATCGGCATTTGAACATAA
ATATCGGGACACGTAATAA -> TATCGGGACACGTAATAAT
ATATCTACGTGCACGGTGA -> TATCTACGTGCACGGTGAT
ATATCTCACGTAATAATCC -> TATCTCACGTAATAATCCG
ATATGAACAGTCAAACACC -> TATGAACAGTCAAACACCC
ATATGGCACCAACAGAGGT -> TATGGCACCAACAGAGGTG
ATCAAAGATTCTACAAGTT -> TCAAAGATTCTACAAGTTG
ATCACATTGTGGGCGAGTT -> TCACATTGTGGGCGAGTTA
ATCACCCGAGCTTCATTGT -> TCACCCGAGCTTCATTGTC
ATCACTACTTTCGCAGGAG -> TCACTACTTTCGCAGGAGG
ATCAGAACGGGATTTCGGC -> TCAGAACGGGATTTCGGCG
ATCAGCAGAAACGCCATCG -> TCAGCAGAAACGCCATCGT
ATCATGTATGACCCCACCC -> TCATGTATGACCCCACCCC
ATCATTACAAGGGTGATTA -> TCATTACAAGGGTGATTAC
ATCCAAGCAGCATGTCACC -> TCCAAGCAGCATGTCACCG
ATCCATCTCACTCTTCAGT -> TCCATCTCACTCTTCAGTT
ATCCCCAACTTCCGTCAGA -> TCCCCAACTTCCGTCAGAA
ATCCCTTTCTTGCAGTATT -> TCCCTTTCTTGCAGTATTC
ATCCGACTTTACCCATACA -> TCCGACTTTACCCATACAG
ATCCGAGGTGTAATGGAGA -> TCCGAGGTGTAATGGAGAC
ATCCGAGGTGTCAGACCCG -> TCCGAGGTGTCAGACCCGG
ATCCGAGGTGTCCTATACG -> TCCGAGGTGTCCTATACGC
ATCCGAGGTGTGACTTTTT -> TCCGAGGTGTGACTTTTTG
ATCGCGTAAAGGGTGAGTA -> TCGCGTAAAGGGTGAGTAC
ATCGCTGCCAGCAAGCACA -> TCGCTGCCAGCAAGCACAT
ATCGGATACGGGCTCGGGT -> TCGGATACGGGCTCGGGTC
ATCGGCATTTGAACATAAG -> TCGGCATTTGAACATAAGA
ATCGGGACACGTAATAATC -> TCGGGACACGTAATAATCC
ATCGGTAAGTAGCTAGCAA -> TCGGTAAGTAGCTAGCAAT
ATCGTCAGGCATGGCAAGC -> TCGTCAGGCATGGCAAGCA
ATCGTCTGGCGAGGGTCGT -> TCGTCTGGCGAGGGTCGTG
ATCGTTCTGTGTCCCTCTT -> TCGTTCTGTGTCCCTCTTT
ATCTAAACTAGTGTCGCGA -> TCTAAACTAGTGTCGCGAA
ATCTACGTGCACGGTGATG -> TCTACGTGCACGGTGATGC
ATCTATGCCCAGACAACGT -> TCTATGCCCAGACAACGTA
ATCTCAAGAAGTACAAGCT -> TCTCAAGAAGTACAAGCTT
ATCTCACGTAATAATCCGA -> TCTCACGTAATAATCCGAG
ATCTCACTCTTCAGTTGGG -> TCTCACTCTTCAGTTGGGC
ATCTCATATCGGGACACGT -> TCTCATATCGGGACACGTA
ATCTCCGTGTTCTGCATGA -> TCTCCGTGTTCTGCATGAG
ATCTCTAGCATCGCGTAAA -> TCTCTAGCATCGCGTAAAG
ATCTGTCTGAACCGTGGAC -> TCTGTCTGAACCGTGGACC
ATCTGTTGCCCTCGGACGT -> TCTGTTGCCCTCGGACGTA
ATCTTCAATCATTACAAGG -> TCTTCAATCATTACAAGGG
ATCTTCCCATCAAAGATTC -> TCTTCCCATCAAAGATTCT
ATCTTGGTATATCTCACGT -> TCTTGGTATATCTCACGTA
ATGAAAACTCTAAGGATGG -> TGAAAACTCTAAGGATGGG
ATGAACACCGGACAAGAGA -> TGAACACCGGACAAGAGAT
ATGAACAGTCAAACACCCC -> TGAACAGTCAAACACCCCA
ATGACCCCACCCCTAACAA -> TGACCCCACCCCTAACAAT
ATGACCTTAATACGTCAAC -> TGACCTTAATACGTCAACA
ATGAGGACCGTATGGGACA -> TGAGGACCGTATGGGACAC
ATGCAGTAGCAACACACAC -> TGCAGTAGCAACACACACG
ATGCAGTGGACCTATTTTA -> TGCAGTGGACCTATTTTAG
ATGCATGGAGAAGAATTTC -> TGCATGGAGAAGAATTTCT
ATGCCAGTTACTCGTCGTT -> TGCCAGTTACTCGTCGTTG
ATGCCCAGACAACGTAATA -> TGCCCAGACAACGTAATAA
ATGCCCCTGTTCGGATGCC -> TGCCCCTGTTCGGATGCCG
ATGCCGTTAAGATATCACA -> TGCCGTTAAGATATCACAT
ATGCGCACTTATGGACACG -> TGCGCACTTATGGACACGC
ATGGACACGCGGTGAATGT -> TGGACACGCGGTGAATGTG
ATGGAGAAGAATTTCTCTT -> TGGAGAAGAATTTCTCTTT
ATGGAGACAAACGTACCAC -> TGGAGACAAACGTACCACA
ATGGAGTGCCAATATCTAC -> TGGAGTGCCAATATCTACG
ATGGCAAGCAACCCAGGGG -> TGGCAAGCAACCCAGGGGC
ATGGCACCAACAGAGGTGG -> TGGCACCAACAGAGGTGGG
ATGGCCGGGCACACCCGTT -> TGGCCGGGCACACCCGTTT
ATGGCTTATTTACAATAAG -> TGGCTTATTTACAATAAGA
ATGGGACACAGTGGGTACA -> TGGGACACAGTGGGTACAA
ATGTAAGTAGCTAGCAATC -> TGTAAGTAGCTAGCAATCT
ATGTACAAACTTAAGGACT -> TGTACAAACTTAAGGACTT
ATGTACGACGCGATAGCAC -> TGTACGACGCGATAGCACC
ATGTAGAGCGGTGACGCCA -> TGTAGAGCGGTGACGCCAT
ATGTATCCGACTTTACCCA -> TGTATCCGACTTTACCCAT
ATGTATGACCCCACCCCTA -> TGTATGACCCCACCCCTAA
ATGTATGTAAGTAGCTAGC -> TGTATGTAAGTAGCTAGCA
ATGTCACCGGACAGCGGCA -> TGTCACCGGACAGCGGCAA
ATGTCACGTGCTTACGTCT -> TGTCACGTGCTTACGTCTG
ATGTGGAGATATGGCACCA -> TGTGGAGATATGGCACCAA
ATGTTCCCTAGGATCCCTT -> TGTTCCCTAGGATCCCTTT
ATTAATCAGCAGAAACGCC -> TTAATCAGCAGAAACGCCA
ATTAATTTAATATCGGCAT -> TTAATTTAATATCGGCATT
ATTACAAGGGTGATTACAT -> TTACAAGGGTGATTACATA
ATTACATAGCGCGAAAGCT -> TTACATAGCGCGAAAGCTA
ATTATCTCCGTGTTCTGCA -> TTATCTCCGTGTTCTGCAT
ATTCGAATTGGTCTCAAGG -> TTCGAATTGGTCTCAAGGC
ATTCGATTTGAAGGTTGGT -> TTCGATTTGAAGGTTGGTC
ATTCTAAGCCTTGGCAGGT -> TTCTAAGCCTTGGCAGGTA
ATTCTACAAGTTGAGGGGC -> TTCTACAAGTTGAGGGGCT
ATTCTGTGCATCGTTCTGT -> TTCTGTGCATCGTTCTGTG
ATTCTTCCTCGTTAGTCTG -> TTCTTCCTCGTTAGTCTGA
ATTGCTTGAACGTGCGGTA -> TTGCTTGAACGTGCGGTAT
ATTGGAAAACACGAACGAG -> TTGGAAAACACGAACGAGC
ATTGGTCTCAAGGCCCGCG -> TTGGTCTCAAGGCCCGCGT
ATTGTCAAACTGGGTAAGG -> TTGTCAAACTGGGTAAGGT
ATTGTGGGCGAGTTAGTCG -> TTGTGGGCGAGTTAGTCGG
ATTTAATATCGGCATTTGA -> TTTAATATCGGCATTTGAA
ATTTACAATAAGACAGACA -> TTTACAATAAGACAGACAT
ATTTACGAGTCTTAAGGGA -> TTTACGAGTCTTAAGGGAG
ATTTCACCAGGGCGGCAAT -> TTTCACCAGGGCGGCAATT
ATTTCGGCGGGGCCGCGCA -> TTTCGGCGGGGCCGCGCAT
ATTTCTCTTTTTCTGTGCT -> TTTCTCTTTTTCTGTGCTA
ATTTCTTTGTGATCTAAAC -> TTTCTTTGTGATCTAAACT
ATTTGAACATAAGAAGTCT -> TTTGAACATAAGAAGTCTT
ATTTGAAGGTTGGTCAGGA -> TTTGAAGGTTGGTCAGGAC
ATTTGCGCAGGGATCATGT -> TTTGCGCAGGGATCATGTA
ATTTTAATGCCCCTGTTCG -> TTTTAATGCCCCTGTTCGG
ATTTTAGGCGGAAAGCTGC -> TTTTAGGCGGAAAGCTGCG
CAAACACCCCACTTGTTAA -> AAACACCCCACTTGTTAAG
CAAACAGAACATCAGAACG -> AAACAGAACATCAGAACGG
CAAACGTACCACAGGTCTA -> AAACGTACCACAGGTCTAC
CAAACTGGGTAAGGTCCTA -> AAACTGGGTAAGGTCCTAT
CAAACTTAAGGACTTCAGG -> AAACTTAAGGACTTCAGGA
CAAAGATTCTACAAGTTGA -> AAAGATTCTACAAGTTGAG
CAAAGGACCCTCTGGATGC -> AAAGGACCCTCTGGATGCA
CAAATACGAACCCAGCTGG -> AAATACGAACCCAGCTGGC
CAACACACACGAACTTCAA -> AACACACACGAACTTCAAA
CAACAGACAGGCTGTTGAC -> AACAGACAGGCTGTTGACG
CAACAGAGGTGGGTATACT -> AACAGAGGTGGGTATACTG
CAACAGGTATCACCCGAGC -> AACAGGTATCACCCGAGCT
CAACCCAGGGGCCTGTGTC -> AACCCAGGGGCCTGTGTCT
CAACGTAATAATCCGAGGT -> AACGTAATAATCCGAGGTG
CAACGTGCTAGGTCAGGTG -> AACGTGCTAGGTCAGGTGA
CAACTTCCGTCAGAACTTT -> AACTTCCGTCAGAACTTTG
CAAGAAGTACAAGCTTGCT -> AAGAAGTACAAGCTTGCTT
CAAGACACTCTTGTTTCCA -> AAGACACTCTTGTTTCCAC
CAAGAGATGTATGTAAGTA -> AAGAGATGTATGTAAGTAG
CAAGCAACCCAGGGGCCTG -> AAGCAACCCAGGGGCCTGT
CAAGCACATGGCTTATTTA -> AAGCACATGGCTTATTTAC
CAAGCAGCATGTCACCGGA -> AAGCAGCATGTCACCGGAC
CAAGCGATGTACAAACTTA -> AAGCGATGTACAAACTTAA
CAAGCTTGCTTGCGAACCC -> AAGCTTGCTTGCGAACCCT
CAAGGCCCGCGTCTCCACC -> AAGGCCCGCGTCTCCACCT
CAAGGGTGATTACATAGCG -> AAGGGTGATTACATAGCGC
CAAGTAACGGCAGTCCTGC -> AAGTAACGGCAGTCCTGCC
CAAGTCTGAACGCCCCTAC -> AAGTCTGAACGCCCCTACG
CAAGTTGAGGGGCTACTAC -> AAGTTGAGGGGCTACTACT
CAATAAGACAGACATGACC -> AATAAGACAGACATGACCT
CAATAAGCGGACTTGTCAT -> AATAAGCGGACTTGTCATG
CAATATCTACGTGCACGGT -> AATATCTACGTGCACGGTG
CAATCATTACAAGGGTGAT -> AATCATTACAAGGGTGATT
CAATCTATGCCCAGACAAC -> AATCTATGCCCAGACAACG
CAATCTCATATCGGGACAC -> AATCTCATATCGGGACACG
CAATCTGTTGCCCTCGGAC -> AATCTGTTGCCCTCGGACG
CAATCTTGGTATATCTCAC -> AATCTTGGTATATCTCACG
CAATTAATCAGCAGAAACG -> AATTAATCAGCAGAAACGC
CAATTGGAAAACACGAACG -> AATTGGAAAACACGAACGA
CACACACGAACTTCAAATA -> ACACACGAACTTCAAATAC
CACACCCGTTTGACCACGC -> ACACCCGTTTGACCACGCT
CACACGAACTTCAAATACG -> ACACGAACTTCAAATACGA
CACAGCAGGACCCAGGAGA -> ACAGCAGGACCCAGGAGAC
CACAGGTCTACGTGGGTTC -> ACAGGTCTACGTGGGTTCG
CACAGTGGGTACAACAGAC -> ACAGTGGGTACAACAGACA
CACATGGCTTATTTACAAT -> ACATGGCTTATTTACAATA
CACATTCTTCCTCGTTAGT -> ACATTCTTCCTCGTTAGTC
CACATTGTGGGCGAGTTAG -> ACATTGTGGGCGAGTTAGT
CACCAACAGAGGTGGGTAT -> ACCAACAGAGGTGGGTATA
CACCAGGGCGGCAATTAAT -> ACCAGGGCGGCAATTAATC
CACCCCACTTGTTAAGTAC -> ACCCCACTTGTTAAGTACA
CACCCCTAACAATTGGAAA -> ACCCCTAACAATTGGAAAA
CACCCGAGCTTCATTGTCA -> ACCCGAGCTTCATTGTCAA
CACCCGTATTTTAATGCCC -> ACCCGTATTTTAATGCCCC
CACCCGTTTGACCACGCTT -> ACCCGTTTGACCACGCTTT
CACCCTATCCATCTCACTC -> ACCCTATCCATCTCACTCT
CACCGAGTGGCTGCACGCT -> ACCGAGTGGCTGCACGCTA
CACCGGACAAGAGATGTAT -> ACCGGACAAGAGATGTATG
CACCGGACAGCGGCAAGTC -> ACCGGACAGCGGCAAGTCT
CACCTGATCACTACTTTCG -> ACCTGATCACTACTTTCGC
CACCTTGTGGCGGCAATAA -> ACCTTGTGGCGGCAATAAG
CACGAACGAGCAAGACACT -> ACGAACGAGCAAGACACTC
CACGAACTTCAAATACGAA -> ACGAACTTCAAATACGAAC
CACGACATTTACGAGTCTT -> ACGACATTTACGAGTCTTA
CACGAGAGAACGACTCATA -> ACGAGAGAACGACTCATAA
CACGCCACGACATTTACGA -> ACGCCACGACATTTACGAG
CACGCGGTGAATGTGGAGA -> ACGCGGTGAATGTGGAGAT
CACGCTATAATAGAGGTGA -> ACGCTATAATAGAGGTGAA
CACGCTTTCTCGCGGGTGA -> ACGCTTTCTCGCGGGTGAG
CACGGTGATGCAGTGGACC -> ACGGTGATGCAGTGGACCT
CACGTAATAATCCGAGGTG -> ACGTAATAATCCGAGGTGT,ACGTAATAATCCGAGGTGT
CACGTGCTTACGTCTGGAC -> ACGTGCTTACGTCTGGACG
CACTACTTTCGCAGGAGGT -> ACTACTTTCGCAGGAGGTA
CACTCTTCAGTTGGGCAGA -> ACTCTTCAGTTGGGCAGAT
CACTCTTGTTTCCACTTAA -> ACTCTTGTTTCCACTTAAC
CACTGTGACAACGTGCTAG -> ACTGTGACAACGTGCTAGG
CACTGTGCGATACTTTCAT -> ACTGTGCGATACTTTCATC
CACTTAACGAACGCACAGC -> ACTTAACGAACGCACAGCA
CACTTATGGACACGCGGTG -> ACTTATGGACACGCGGTGA
CACTTGTTAAGTACAGTCG -> ACTTGTTAAGTACAGTCGC
CACTTTGCACTGTGACAAC -> ACTTTGCACTGTGACAACG
CAGAAACGCCATCGTCAGG -> AGAAACGCCATCGTCAGGC
CAGAACATCAGAACGGGAT -> AGAACATCAGAACGGGATT
CAGAACGGGATTTCGGCGG -> AGAACGGGATTTCGGCGGG
CAGAACTTTGGACGATATG -> AGAACTTTGGACGATATGA
CAGACAACGTAATAATCCG -> AGACAACGTAATAATCCGA
CAGACAGGCTGTTGACGCA -> AGACAGGCTGTTGACGCAC
CAGACATGACCTTAATACG -> AGACATGACCTTAATACGT
CAGACCCGGGAGCTCCACT -> AGACCCGGGAGCTCCACTG
CAGAGGTGGGTATACTGAT -> AGAGGTGGGTATACTGATA
CAGATTTGCGCAGGGATCA -> AGATTTGCGCAGGGATCAT
CAGCAAACAGAACATCAGA -> AGCAAACAGAACATCAGAA
CAGCAAGCACATGGCTTAT -> AGCAAGCACATGGCTTATT
CAGCAGAAACGCCATCGTC -> AGCAGAAACGCCATCGTCA
CAGCAGCAAACAGAACATC -> AGCAGCAAACAGAACATCA
CAGCAGGACCCAGGAGACC -> AGCAGGACCCAGGAGACCA
CAGCATGTCACCGGACAGC -> AGCATGTCACCGGACAGCG
CAGCCCGTAGACGATATAG -> AGCCCGTAGACGATATAGG
CAGCCGATTCTGTGCATCG -> AGCCGATTCTGTGCATCGT
CAGCGATGCATGGAGAAGA -> AGCGATGCATGGAGAAGAA
CAGCGCATCCCCAACTTCC -> AGCGCATCCCCAACTTCCG
CAGCGCGCGGTCAGCGATG -> AGCGCGCGGTCAGCGATGC
CAGCGGCAAGTCTGAACGC -> AGCGGCAAGTCTGAACGCC
CAGCTGGCATGAACACCGG -> AGCTGGCATGAACACCGGA
CAGGACCCAGGAGACCATG -> AGGACCCAGGAGACCATGT
CAGGACGGGCAGTCCGCAT -> AGGACGGGCAGTCCGCATG
CAGGAGACCATGTCACGTG -> AGGAGACCATGTCACGTGC
CAGGAGGATCGCTGCCAGC -> AGGAGGATCGCTGCCAGCA
CAGGAGGTATCTGTCTGAA -> AGGAGGTATCTGTCTGAAC
CAGGAGTAAGTAGCTAGCA -> AGGAGTAAGTAGCTAGCAA
CAGGCATGGCAAGCAACCC -> AGGCATGGCAAGCAACCCA
CAGGCTGTTGACGCACGAG -> AGGCTGTTGACGCACGAGA
CAGGGATCATGTATGACCC -> AGGGATCATGTATGACCCC
CAGGGCGGCAATTAATCAG -> AGGGCGGCAATTAATCAGC
CAGGGGCCTGTGTCTTTTG -> AGGGGCCTGTGTCTTTTGC
CAGGTACACCTGATCACTA -> AGGTACACCTGATCACTAC
CAGGTATCACCCGAGCTTC -> AGGTATCACCCGAGCTTCA
CAGGTCTACGTGGGTTCGT -> AGGTCTACGTGGGTTCGTT
CAGGTGAACGCAGCCCGTA -> AGGTGAACGCAGCCCGTAG
CAGTAAGACATGTAGAGCG -> AGTAAGACATGTAGAGCGG
CAGTAGCAACACACACGAA -> AGTAGCAACACACACGAAC
CAGTATTCTAAGCCTTGGC -> AGTATTCTAAGCCTTGGCA
CAGTCAAACACCCCACTTG -> AGTCAAACACCCCACTTGT
CAGTCCGCATGGCCGGGCA -> AGTCCGCATGGCCGGGCAC
CAGTCCTGCCGTAAGTAGC -> AGTCCTGCCGTAAGTAGCT
CAGTCGCCCCGTTGCCAGG -> AGTCGCCCCGTTGCCAGGA
CAGTGGACCTATTTTAGGC -> AGTGGACCTATTTTAGGCG
CAGTGGGTACAACAGACAG -> AGTGGGTACAACAGACAGG
CAGTTACTCGTCGTTGTGG -> AGTTACTCGTCGTTGTGGA
CAGTTGGGCAGATTTGCGC -> AGTTGGGCAGATTTGCGCA
CATAAGAAGTCTTGCGGAG -> ATAAGAAGTCTTGCGGAGC
CATAATGCCAGTTACTCGT -> ATAATGCCAGTTACTCGTC
CATACAGCAGCAAACAGAA -> ATACAGCAGCAAACAGAAC
CATAGCGCGAAAGCTAGGA -> ATAGCGCGAAAGCTAGGAC
CATATCGGGACACGTAATA -> ATATCGGGACACGTAATAA
CATCAAAGATTCTACAAGT -> ATCAAAGATTCTACAAGTT
CATCAGAACGGGATTTCGG -> ATCAGAACGGGATTTCGGC
CATCCAAGCAGCATGTCAC -> ATCCAAGCAGCATGTCACC
CATCCCCAACTTCCGTCAG -> ATCCCCAACTTCCGTCAGA
CATCGCGTAAAGGGTGAGT -> ATCGCGTAAAGGGTGAGTA
CATCGGATACGGGCTCGGG -> ATCGGATACGGGCTCGGGT
CATCGGTAAGTAGCTAGCA -> ATCGGTAAGTAGCTAGCAA
CATCGTCAGGCATGGCAAG -> ATCGTCAGGCATGGCAAGC
CATCGTCTGGCGAGGGTCG -> ATCGTCTGGCGAGGGTCGT
CATCGTTCTGTGTCCCTCT -> ATCGTTCTGTGTCCCTCTT
CATCTCAAGAAGTACAAGC -> ATCTCAAGAAGTACAAGCT
CATCTCACTCTTCAGTTGG -> ATCTCACTCTTCAGTTGGG
CATCTTCAATCATTACAAG -> ATCTTCAATCATTACAAGG
CATGAAAACTCTAAGGATG -> ATGAAAACTCTAAGGATGG
CATGAACACCGGACAAGAG -> ATGAACACCGGACAAGAGA
CATGACCTTAATACGTCAA -> ATGACCTTAATACGTCAAC
CATGAGGACCGTATGGGAC -> ATGAGGACCGTATGGGACA
CATGCGCACTTATGGACAC -> ATGCGCACTTATGGACACG
CATGGAGAAGAATTTCTCT -> ATGGAGAAGAATTTCTCTT
CATGGCAAGCAACCCAGGG -> ATGGCAAGCAACCCAGGGG
CATGGCCGGGCACACCCGT -> ATGGCCGGGCACACCCGTT
CATGGCTTATTTACAATAA -> ATGGCTTATTTACAATAAG
CATGTAGAGCGGTGACGCC -> ATGTAGAGCGGTGACGCCA
CATGTATGACCCCACCCCT -> ATGTATGACCCCACCCCTA
CATGTCACCGGACAGCGGC -> ATGTCACCGGACAGCGGCA
CATGTCACGTGCTTACGTC -> ATGTCACGTGCTTACGTCT
CATTACAAGGGTGATTACA -> ATTACAAGGGTGATTACAT
CATTATCTCCGTGTTCTGC -> ATTATCTCCGTGTTCTGCA
CATTCTTCCTCGTTAGTCT -> ATTCTTCCTCGTTAGTCTG
CATTGCTTGAACGTGCGGT -> ATTGCTTGAACGTGCGGTA
CATTGTCAAACTGGGTAAG -> ATTGTCAAACTGGGTAAGG
CATTGTGGGCGAGTTAGTC -> ATTGTGGGCGAGTTAGTCG
CATTTACGAGTCTTAAGGG -> ATTTACGAGTCTTAAGGGA
CATTTGAACATAAGAAGTC -> ATTTGAACATAAGAAGTCT
CCAAAGGACCCTCTGGATG -> CAAAGGACCCTCTGGATGC
CCAACAGAGGTGGGTATAC -> CAACAGAGGTGGGTATACT
CCAACTTCCGTCAGAACTT -> CAACTTCCGTCAGAACTTT
CCAAGCAGCATGTCACCGG -> CAAGCAGCATGTCACCGGA
CCAATATCTACGTGCACGG -> CAATATCTACGTGCACGGT
CCACAGGTCTACGTGGGTT -> CACAGGTCTACGTGGGTTC
CCACATTCTTCCTCGTTAG -> CACATTCTTCCTCGTTAGT
CCACCCCTAACAATTGGAA -> CACCCCTAACAATTGGAAA
CCACCCTATCCATCTCACT -> CACCCTATCCATCTCACTC
CCACCTTGTGGCGGCAATA -> CACCTTGTGGCGGCAATAA
CCACGACATTTACGAGTCT -> CACGACATTTACGAGTCTT
CCACGCCACGACATTTACG -> CACGCCACGACATTTACGA
CCACGCTTTCTCGCGGGTG -> CACGCTTTCTCGCGGGTGA
CCACTGTGCGATACTTTCA -> CACTGTGCGATACTTTCAT
CCACTTAACGAACGCACAG -> CACTTAACGAACGCACAGC
CCACTTGTTAAGTACAGTC -> CACTTGTTAAGTACAGTCG
CCACTTTGCACTGTGACAA -> CACTTTGCACTGTGACAAC
CCAGACAACGTAATAATCC -> CAGACAACGTAATAATCCG
CCAGCAAGCACATGGCTTA -> CAGCAAGCACATGGCTTAT
CCAGCTGGCATGAACACCG -> CAGCTGGCATGAACACCGG
CCAGGAGACCATGTCACGT -> CAGGAGACCATGTCACGTG
CCAGGAGTAAGTAGCTAGC -> CAGGAGTAAGTAGCTAGCA
CCAGGGCGGCAATTAATCA -> CAGGGCGGCAATTAATCAG
CCAGGGGCCTGTGTCTTTT -> CAGGGGCCTGTGTCTTTTG
CCAGTAAGACATGTAGAGC -> CAGTAAGACATGTAGAGCG
CCAGTTACTCGTCGTTGTG -> CAGTTACTCGTCGTTGTGG
CCATACAGCAGCAAACAGA -> CATACAGCAGCAAACAGAA
CCATCAAAGATTCTACAAG -> CATCAAAGATTCTACAAGT
CCATCCAAGCAGCATGTCA -> CATCCAAGCAGCATGTCAC
CCATCGTCAGGCATGGCAA -> CATCGTCAGGCATGGCAAG
CCATCGTCTGGCGAGGGTC -> CATCGTCTGGCGAGGGTCG
CCATCTCAAGAAGTACAAG -> CATCTCAAGAAGTACAAGC
CCATCTCACTCTTCAGTTG -> CATCTCACTCTTCAGTTGG
CCATGTCACGTGCTTACGT -> CATGTCACGTGCTTACGTC
CCATTATCTCCGTGTTCTG -> CATTATCTCCGTGTTCTGC
CCCAACTTCCGTCAGAACT -> CCAACTTCCGTCAGAACTT
CCCACCCCTAACAATTGGA -> CCACCCCTAACAATTGGAA
CCCACCCTATCCATCTCAC -> CCACCCTATCCATCTCACT
CCCACGCCACGACATTTAC -> CCACGCCACGACATTTACG
CCCACTTGTTAAGTACAGT -> CCACTTGTTAAGTACAGTC
CCCAGACAACGTAATAATC -> CCAGACAACGTAATAATCC
CCCAGCTGGCATGAACACC -> CCAGCTGGCATGAACACCG
CCCAGGAGACCATGTCACG -> CCAGGAGACCATGTCACGT
CCCAGGGGCCTGTGTCTTT -> CCAGGGGCCTGTGTCTTTT
CCCATACAGCAGCAAACAG -> CCATACAGCAGCAAACAGA
CCCATCAAAGATTCTACAA -> CCATCAAAGATTCTACAAG
CCCCAACTTCCGTCAGAAC -> CCCAACTTCCGTCAGAACT
CCCCACCCCTAACAATTGG -> CCCACCCCTAACAATTGGA
CCCCACTTGTTAAGTACAG -> CCCACTTGTTAAGTACAGT
CCCCGTTGCCAGGAGTAAG -> CCCGTTGCCAGGAGTAAGT
CCCCTAACAATTGGAAAAC -> CCCTAACAATTGGAAAACA
CCCCTACGCCAGTAAGACA -> CCCTACGCCAGTAAGACAT
CCCCTGTTCGGATGCCGTT -> CCCTGTTCGGATGCCGTTA
CCCGAGCTTCATTGTCAAA -> CCGAGCTTCATTGTCAAAC
CCCGCATGAAAACTCTAAG -> CCGCATGAAAACTCTAAGG
CCCGCCATCTCAAGAAGTA -> CCGCCATCTCAAGAAGTAC
CCCGCGTCTCCACCTTGTG -> CCGCGTCTCCACCTTGTGG
CCCGGGAGCTCCACTGTGC -> CCGGGAGCTCCACTGTGCG
CCCGTAGACGATATAGGGA -> CCGTAGACGATATAGGGAC
CCCGTATTTTAATGCCCCT -> CCGTATTTTAATGCCCCTG
CCCGTTGCCAGGAGTAAGT -> CCGTTGCCAGGAGTAAGTA
CCCGTTTGACCACGCTTTC -> CCGTTTGACCACGCTTTCT
CCCTAACAATTGGAAAACA -> CCTAACAATTGGAAAACAC
CCCTACGCCAGTAAGACAT -> CCTACGCCAGTAAGACATG
CCCTAGGATCCCTTTCTTG -> CCTAGGATCCCTTTCTTGC
CCCTATCCATCTCACTCTT -> CCTATCCATCTCACTCTTC
CCCTATTTCACCAGGGCGG -> CCTATTTCACCAGGGCGGC
CCCTCAGCGCATCCCCAAC -> CCTCAGCGCATCCCCAACT
CCCTCGGACGTAATAATCC -> CCTCGGACGTAATAATCCG
CCCTCTGGATGCAGTAGCA -> CCTCTGGATGCAGTAGCAA
CCCTCTTTCATCGGTAAGT -> CCTCTTTCATCGGTAAGTA
CCCTGTTCGGATGCCGTTA -> CCTGTTCGGATGCCGTTAA
CCCTTTCTTGCAGTATTCT -> CCTTTCTTGCAGTATTCTA
CCGAATGTACGACGCGATA -> CGAATGTACGACGCGATAG
CCGACTTTACCCATACAGC -> CGACTTTACCCATACAGCA
CCGAGCTTCATTGTCAAAC -> CGAGCTTCATTGTCAAACT
CCGAGGTGTAATGGAGACA -> CGAGGTGTAATGGAGACAA
CCGAGGTGTCAGACCCGGG -> CGAGGTGTCAGACCCGGGA
CCGAGGTGTCCTATACGCA -> CGAGGTGTCCTATACGCAA
CCGAGGTGTGACTTTTTGT -> CGAGGTGTGACTTTTTGTC
CCGAGTGGCTGCACGCTAT -> CGAGTGGCTGCACGCTATA
CCGATTCTGTGCATCGTTC -> CGATTCTGTGCATCGTTCT
CCGCATGAAAACTCTAAGG -> CGCATGAAAACTCTAAGGA
CCGCATGGCCGGGCACACC -> CGCATGGCCGGGCACACCC
CCGCCATCTCAAGAAGTAC -> CGCCATCTCAAGAAGTACA
CCGCGCATCGGATACGGGC -> CGCGCATCGGATACGGGCT
CCGCGTCTCCACCTTGTGG -> CGCGTCTCCACCTTGTGGC
CCGGACAAGAGATGTATGT -> CGGACAAGAGATGTATGTA
CCGGACAGCGGCAAGTCTG -> CGGACAGCGGCAAGTCTGA
CCGGCCGAATGTACGACGC -> CGGCCGAATGTACGACGCG
CCGGGAGCTCCACTGTGCG -> CGGGAGCTCCACTGTGCGA
CCGGGCACACCCGTTTGAC -> CGGGCACACCCGTTTGACC
CCGTAAGTAGCTAGCAATC -> CGTAAGTAGCTAGCAATCT
CCGTAGACGATATAGGGAC -> CGTAGACGATATAGGGACT
CCGTATGGGACACAGTGGG -> CGTATGGGACACAGTGGGT
CCGTATTTTAATGCCCCTG -> CGTATTTTAATGCCCCTGT
CCGTCAGAACTTTGGACGA -> CGTCAGAACTTTGGACGAT
CCGTGGACCGGCCGAATGT -> CGTGGACCGGCCGAATGTA
CCGTGTTCTGCATGAGGAC -> CGTGTTCTGCATGAGGACC
CCGTTAAGATATCACATTG -> CGTTAAGATATCACATTGT
CCGTTGCCAGGAGTAAGTA -> CGTTGCCAGGAGTAAGTAG
CCGTTTGACCACGCTTTCT -> CGTTTGACCACGCTTTCTC
CCTAACAATTGGAAAACAC -> CTAACAATTGGAAAACACG
CCTACGCCAGTAAGACATG -> CTACGCCAGTAAGACATGT
CCTAGGATCCCTTTCTTGC -> CTAGGATCCCTTTCTTGCA
CCTATACGCAAGTAACGGC -> CTATACGCAAGTAACGGCA
CCTATCCATCTCACTCTTC -> CTATCCATCTCACTCTTCA
CCTATTCGATTTGAAGGTT -> CTATTCGATTTGAAGGTTG
CCTATTTCACCAGGGCGGC -> CTATTTCACCAGGGCGGCA
CCTATTTTAGGCGGAAAGC -> CTATTTTAGGCGGAAAGCT
CCTCAGCGCATCCCCAACT -> CTCAGCGCATCCCCAACTT
CCTCCATCGTCTGGCGAGG -> CTCCATCGTCTGGCGAGGG
CCTCGGACGTAATAATCCG -> CTCGGACGTAATAATCCGA
CCTCGTTAGTCTGAGGGAT -> CTCGTTAGTCTGAGGGATC
CCTCTGGATGCAGTAGCAA -> CTCTGGATGCAGTAGCAAC
CCTCTTTCATCGGTAAGTA -> CTCTTTCATCGGTAAGTAG
CCTGAGAGATGTTCCCTAG -> CTGAGAGATGTTCCCTAGG
CCTGATCACTACTTTCGCA -> CTGATCACTACTTTCGCAG
CCTGCCGTAAGTAGCTAGC -> CTGCCGTAAGTAGCTAGCA
CCTGTGTCTTTTGCAGCGC -> CTGTGTCTTTTGCAGCGCG
CCTGTTCGGATGCCGTTAA -> CTGTTCGGATGCCGTTAAG
CCTTAATACGTCAACAGGT -> CTTAATACGTCAACAGGTA
CCTTGGCAGGTACACCTGA -> CTTGGCAGGTACACCTGAT
CCTTGTGGCGGCAATAAGC -> CTTGTGGCGGCAATAAGCG
CCTTTCTTGCAGTATTCTA -> CTTTCTTGCAGTATTCTAA
CGAAAGCTAGGACCATCCA -> GAAAGCTAGGACCATCCAA
CGAACCCAGCTGGCATGAA -> GAACCCAGCTGGCATGAAC
CGAACCCTATTTCACCAGG -> GAACCCTATTTCACCAGGG
CGAACGAGCAAGACACTCT -> GAACGAGCAAGACACTCTT
CGAACGCACAGCAGGACCC -> GAACGCACAGCAGGACCCA
CGAACTTCAAATACGAACC -> GAACTTCAAATACGAACCC
CGAAGTTCTAGCCCTCAGC -> GAAGTTCTAGCCCTCAGCG
CGAATGTACGACGCGATAG -> GAATGTACGACGCGATAGC
CGAATTGGTCTCAAGGCCC -> GAATTGGTCTCAAGGCCCG
CGACATTTACGAGTCTTAA -> GACATTTACGAGTCTTAAG
CGACCTGAGAGATGTTCCC -> GACCTGAGAGATGTTCCCT
CGACGCGATAGCACCCGTA -> GACGCGATAGCACCCGTAT
CGACTCATAATGCCAGTTA -> GACTCATAATGCCAGTTAC
CGACTTTACCCATACAGCA -> GACTTTACCCATACAGCAG
CGAGAGAACGACTCATAAT -> GAGAGAACGACTCATAATG
CGAGCAAGACACTCTTGTT -> GAGCAAGACACTCTTGTTT
CGAGCTTCATTGTCAAACT -> GAGCTTCATTGTCAAACTG
CGAGGGTCGTGCCAAAGGA -> GAGGGTCGTGCCAAAGGAC
CGAGGTGTAATGGAGACAA -> GAGGTGTAATGGAGACAAA
CGAGGTGTCAGACCCGGGA -> GAGGTGTCAGACCCGGGAG
CGAGGTGTCCTATACGCAA -> GAGGTGTCCTATACGCAAG
CGAGGTGTGACTTTTTGTC -> GAGGTGTGACTTTTTGTCC
CGAGTCTTAAGGGAGTCGC -> GAGTCTTAAGGGAGTCGCC
CGAGTGGCTGCACGCTATA -> GAGTGGCTGCACGCTATAA
CGAGTTAGTCGGTTGAACC -> GAGTTAGTCGGTTGAACCC
CGATACTTTCATCTTCAAT -> GATACTTTCATCTTCAATC
CGATAGCACCCGTATTTTA -> GATAGCACCCGTATTTTAA
CGATATAGGGACTAGATGG -> GATATAGGGACTAGATGGA
CGATATGAACAGTCAAACA -> GATATGAACAGTCAAACAC
CGATGCATGGAGAAGAATT -> GATGCATGGAGAAGAATTT
CGATGTACAAACTTAAGGA -> GATGTACAAACTTAAGGAC
CGATTCTGTGCATCGTTCT -> GATTCTGTGCATCGTTCTG
CGATTTCTTTGTGATCTAA -> GATTTCTTTGTGATCTAAA
CGATTTGAAGGTTGGTCAG -> GATTTGAAGGTTGGTCAGG
CGCAAGTAACGGCAGTCCT -> GCAAGTAACGGCAGTCCTG
CGCACAGCAGGACCCAGGA -> GCACAGCAGGACCCAGGAG
CGCACGAGAGAACGACTCA -> GCACGAGAGAACGACTCAT
CGCACTTATGGACACGCGG -> GCACTTATGGACACGCGGT
CGCAGCCCGTAGACGATAT -> GCAGCCCGTAGACGATATA
CGCAGGAGGTATCTGTCTG -> GCAGGAGGTATCTGTCTGA
CGCAGGGATCATGTATGAC -> GCAGGGATCATGTATGACC
CGCATCCCCAACTTCCGTC -> GCATCCCCAACTTCCGTCA
CGCATCGGATACGGGCTCG -> GCATCGGATACGGGCTCGG
CGCATGAAAACTCTAAGGA -> GCATGAAAACTCTAAGGAT
CGCATGGCCGGGCACACCC -> GCATGGCCGGGCACACCCG
CGCCACATTCTTCCTCGTT -> GCCACATTCTTCCTCGTTA
CGCCACGACATTTACGAGT -> GCCACGACATTTACGAGTC
CGCCAGTAAGACATGTAGA -> GCCAGTAAGACATGTAGAG
CGCCATCGTCAGGCATGGC -> GCCATCGTCAGGCATGGCA
CGCCATCTCAAGAAGTACA -> GCCATCTCAAGAAGTACAA
CGCCATTATCTCCGTGTTC -> GCCATTATCTCCGTGTTCT
CGCCCCGTTGCCAGGAGTA -> GCCCCGTTGCCAGGAGTAA
CGCCCCTACGCCAGTAAGA -> GCCCCTACGCCAGTAAGAC
CGCGAAAGCTAGGACCATC -> GCGAAAGCTAGGACCATCC
CGCGAAGTTCTAGCCCTCA -> GCGAAGTTCTAGCCCTCAG
CGCGATAGCACCCGTATTT -> GCGATAGCACCCGTATTTT
CGCGCATCGGATACGGGCT -> GCGCATCGGATACGGGCTC
CGCGCGGTCAGCGATGCAT -> GCGCGGTCAGCGATGCATG
CGCGGGTGAGGTAGACCCG -> GCGGGTGAGGTAGACCCGC
CGCGGTCAGCGATGCATGG -> GCGGTCAGCGATGCATGGA
CGCGGTGAATGTGGAGATA -> GCGGTGAATGTGGAGATAT
CGCGTAAAGGGTGAGTACC -> GCGTAAAGGGTGAGTACCA
CGCGTCTCCACCTTGTGGC -> GCGTCTCCACCTTGTGGCG
CGCTATAATAGAGGTGAAT -> GCTATAATAGAGGTGAATT
CGCTGCCAGCAAGCACATG -> GCTGCCAGCAAGCACATGG
CGCTTTCTCGCGGGTGAGG -> GCTTTCTCGCGGGTGAGGT
CGGAAAGCTGCGTAGATAG -> GGAAAGCTGCGTAGATAGC
CGGACAAGAGATGTATGTA -> GGACAAGAGATGTATGTAA
CGGACAGCGGCAAGTCTGA -> GGACAGCGGCAAGTCTGAA
CGGACGTAATAATCCGAGG -> GGACGTAATAATCCGAGGT
CGGACTTGTCATGCGCACT -> GGACTTGTCATGCGCACTT
CGGAGCTGTGAGTGTGAAG -> GGAGCTGTGAGTGTGAAGC
CGGATACGGGCTCGGGTCT -> GGATACGGGCTCGGGTCTC
CGGATGCCGTTAAGATATC -> GGATGCCGTTAAGATATCA
CGGCAAGTCTGAACGCCCC -> GGCAAGTCTGAACGCCCCT
CGGCAATAAGCGGACTTGT -> GGCAATAAGCGGACTTGTC
CGGCAATTAATCAGCAGAA -> GGCAATTAATCAGCAGAAA
CGGCAGTCCTGCCGTAAGT -> GGCAGTCCTGCCGTAAGTA
CGGCATTTGAACATAAGAA -> GGCATTTGAACATAAGAAG
CGGCCGAATGTACGACGCG -> GGCCGAATGTACGACGCGA
CGGCGGGGCCGCGCATCGG -> GGCGGGGCCGCGCATCGGA
CGGGACACGTAATAATCCG -> GGGACACGTAATAATCCGA
CGGGAGCTCCACTGTGCGA -> GGGAGCTCCACTGTGCGAT
CGGGATTTCGGCGGGGCCG -> GGGATTTCGGCGGGGCCGC
CGGGCACACCCGTTTGACC -> GGGCACACCCGTTTGACCA
CGGGCAGTCCGCATGGCCG -> GGGCAGTCCGCATGGCCGG
CGGGCTCGGGTCTCCTCCA -> GGGCTCGGGTCTCCTCCAT
CGGGGCCGCGCATCGGATA -> GGGGCCGCGCATCGGATAC
CGGGTCTCCTCCATCGTCT -> GGGTCTCCTCCATCGTCTG
CGGGTGAGGTAGACCCGCA -> GGGTGAGGTAGACCCGCAT
CGGTAAGTAGCTAGCAATC -> GGTAAGTAGCTAGCAATCT
CGGTATTCGAATTGGTCTC -> GGTATTCGAATTGGTCTCA
CGGTCAGCGATGCATGGAG -> GGTCAGCGATGCATGGAGA
CGGTGAATGTGGAGATATG -> GGTGAATGTGGAGATATGG
CGGTGACGCCATTATCTCC -> GGTGACGCCATTATCTCCG
CGGTGATGCAGTGGACCTA -> GGTGATGCAGTGGACCTAT
CGGTTGAACCCGCCATCTC -> GGTTGAACCCGCCATCTCA
CGTAAAGGGTGAGTACCAC -> GTAAAGGGTGAGTACCACT
CGTAAGTAGCTAGCAATCT -> GTAAGTAGCTAGCAATCTC
CGTAATAATCCGAGGTGTA -> GTAATAATCCGAGGTGTAA
CGTAATAATCCGAGGTGTC -> GTAATAATCCGAGGTGTCA,GTAATAATCCGAGGTGTCC
CGTAATAATCCGAGGTGTG -> GTAATAATCCGAGGTGTGA
CGTACCACAGGTCTACGTG -> GTACCACAGGTCTACGTGG
CGTAGACGATATAGGGACT -> GTAGACGATATAGGGACTA
CGTAGATAGCATTGCTTGA -> GTAGATAGCATTGCTTGAA
CGTATGGGACACAGTGGGT -> GTATGGGACACAGTGGGTA
CGTATTTTAATGCCCCTGT -> GTATTTTAATGCCCCTGTT
CGTCAACAGGTATCACCCG -> GTCAACAGGTATCACCCGA
CGTCAGAACTTTGGACGAT -> GTCAGAACTTTGGACGATA
CGTCAGGCATGGCAAGCAA -> GTCAGGCATGGCAAGCAAC
CGTCGTTGTGGAGGGGTTA -> GTCGTTGTGGAGGGGTTAA
CGTCTAACGACCTGAGAGA -> GTCTAACGACCTGAGAGAT
CGTCTCCACCTTGTGGCGG -> GTCTCCACCTTGTGGCGGC
CGTCTGGACGTCTAACGAC -> GTCTGGACGTCTAACGACC
CGTCTGGCGAGGGTCGTGC -> GTCTGGCGAGGGTCGTGCC
CGTGCACGGTGATGCAGTG -> GTGCACGGTGATGCAGTGG
CGTGCCAAAGGACCCTCTG -> GTGCCAAAGGACCCTCTGG
CGTGCGGTATTCGAATTGG -> GTGCGGTATTCGAATTGGT
CGTGCTAGGTCAGGTGAAC -> GTGCTAGGTCAGGTGAACG
CGTGCTTACGTCTGGACGT -> GTGCTTACGTCTGGACGTC
CGTGGACCGGCCGAATGTA -> GTGGACCGGCCGAATGTAC
CGTGGGTTCGTTCAAGCGA -> GTGGGTTCGTTCAAGCGAT
CGTGTTCTGCATGAGGACC -> GTGTTCTGCATGAGGACCG
CGTTAAGATATCACATTGT -> GTTAAGATATCACATTGTG
CGTTAGTCTGAGGGATCTC -> GTTAGTCTGAGGGATCTCT
CGTTCAAGCGATGTACAAA -> GTTCAAGCGATGTACAAAC
CGTTCTGTGTCCCTCTTTC -> GTTCTGTGTCCCTCTTTCA
CGTTGCCAGGAGTAAGTAG -> GTTGCCAGGAGTAAGTAGC
CGTTGTGGAGGGGTTAATC -> GTTGTGGAGGGGTTAATCT
CGTTTGACCACGCTTTCTC -> GTTTGACCACGCTTTCTCG
CTAAACTAGTGTCGCGAAG -> TAAACTAGTGTCGCGAAGT
CTAACAATTGGAAAACACG -> TAACAATTGGAAAACACGA
CTAACGACCTGAGAGATGT -> TAACGACCTGAGAGATGTT
CTAAGCCTTGGCAGGTACA -> TAAGCCTTGGCAGGTACAC
CTAATGTATCCGACTTTAC -> TAATGTATCCGACTTTACC
CTACAAGTTGAGGGGCTAC -> TACAAGTTGAGGGGCTACT
CTACGATTTCTTTGTGATC -> TACGATTTCTTTGTGATCT
CTACGCCAGTAAGACATGT -> TACGCCAGTAAGACATGTA
CTACGTGCACGGTGATGCA -> TACGTGCACGGTGATGCAG
CTACGTGGGTTCGTTCAAG -> TACGTGGGTTCGTTCAAGC
CTACTAATGTATCCGACTT -> TACTAATGTATCCGACTTT
CTACTACTAATGTATCCGA -> TACTACTAATGTATCCGAC
CTACTTTCGCAGGAGGTAT -> TACTTTCGCAGGAGGTATC
CTAGATGGAGTGCCAATAT -> TAGATGGAGTGCCAATATC
CTAGCAATCTATGCCCAGA -> TAGCAATCTATGCCCAGAC
CTAGCAATCTCATATCGGG -> TAGCAATCTCATATCGGGA
CTAGCAATCTGTTGCCCTC -> TAGCAATCTGTTGCCCTCG
CTAGCAATCTTGGTATATC -> TAGCAATCTTGGTATATCT
CTAGCATCGCGTAAAGGGT -> TAGCATCGCGTAAAGGGTG
CTAGCCCTCAGCGCATCCC -> TAGCCCTCAGCGCATCCCC
CTAGGACCATCCAAGCAGC -> TAGGACCATCCAAGCAGCA
CTAGGATCCCTTTCTTGCA -> TAGGATCCCTTTCTTGCAG
CTAGGTCAGGTGAACGCAG -> TAGGTCAGGTGAACGCAGC
CTAGTGTCGCGAAGTTCTA -> TAGTGTCGCGAAGTTCTAG
CTATAATAGAGGTGAATTA -> TATAATAGAGGTGAATTAA
CTATACGCAAGTAACGGCA -> TATACGCAAGTAACGGCAG
CTATCCATCTCACTCTTCA -> TATCCATCTCACTCTTCAG
CTATGCCCAGACAACGTAA -> TATGCCCAGACAACGTAAT
CTATTCGATTTGAAGGTTG -> TATTCGATTTGAAGGTTGG
CTATTTCACCAGGGCGGCA -> TATTTCACCAGGGCGGCAA
CTATTTTAGGCGGAAAGCT -> TATTTTAGGCGGAAAGCTG
CTCAAGAAGTACAAGCTTG -> TCAAGAAGTACAAGCTTGC
CTCAAGGCCCGCGTCTCCA -> TCAAGGCCCGCGTCTCCAC
CTCACGTAATAATCCGAGG -> TCACGTAATAATCCGAGGT
CTCACTCTTCAGTTGGGCA -> TCACTCTTCAGTTGGGCAG
CTCAGCGCATCCCCAACTT -> TCAGCGCATCCCCAACTTC
CTCATAATGCCAGTTACTC -> TCATAATGCCAGTTACTCG
CTCATATCGGGACACGTAA -> TCATATCGGGACACGTAAT
CTCCACCTTGTGGCGGCAA -> TCCACCTTGTGGCGGCAAT
CTCCACTGTGCGATACTTT -> TCCACTGTGCGATACTTTC
CTCCATCGTCTGGCGAGGG -> TCCATCGTCTGGCGAGGGT
CTCCGTGTTCTGCATGAGG -> TCCGTGTTCTGCATGAGGA
CTCCTCCATCGTCTGGCGA -> TCCTCCATCGTCTGGCGAG
CTCGCGGGTGAGGTAGACC -> TCGCGGGTGAGGTAGACCC
CTCGGACGTAATAATCCGA -> TCGGACGTAATAATCCGAG
CTCGGGTCTCCTCCATCGT -> TCGGGTCTCCTCCATCGTC
CTCGTCGTTGTGGAGGGGT -> TCGTCGTTGTGGAGGGGTT
CTCGTTAGTCTGAGGGATC -> TCGTTAGTCTGAGGGATCT
CTCTAGCATCGCGTAAAGG -> TCTAGCATCGCGTAAAGGG
CTCTGGATGCAGTAGCAAC -> TCTGGATGCAGTAGCAACA
CTCTTCAGTTGGGCAGATT -> TCTTCAGTTGGGCAGATTT
CTCTTGTTTCCACTTAACG -> TCTTGTTTCCACTTAACGA
CTCTTTCATCGGTAAGTAG -> TCTTTCATCGGTAAGTAGC
CTCTTTTTCTGTGCTACGA -> TCTTTTTCTGTGCTACGAT
CTGAACCGTGGACCGGCCG -> TGAACCGTGGACCGGCCGA
CTGAACGCCCCTACGCCAG -> TGAACGCCCCTACGCCAGT
CTGAGAGATGTTCCCTAGG -> TGAGAGATGTTCCCTAGGA
CTGAGGGATCTCTAGCATC -> TGAGGGATCTCTAGCATCG
CTGATACTGCACCGAGTGG -> TGATACTGCACCGAGTGGC
CTGATCACTACTTTCGCAG -> TGATCACTACTTTCGCAGG
CTGCACCGAGTGGCTGCAC -> TGCACCGAGTGGCTGCACG
CTGCACGCTATAATAGAGG -> TGCACGCTATAATAGAGGT
CTGCATGAGGACCGTATGG -> TGCATGAGGACCGTATGGG
CTGCCAGCAAGCACATGGC -> TGCCAGCAAGCACATGGCT
CTGCCCACCCTATCCATCT -> TGCCCACCCTATCCATCTC
CTGCCGTAAGTAGCTAGCA -> TGCCGTAAGTAGCTAGCAA
CTGCGTAGATAGCATTGCT -> TGCGTAGATAGCATTGCTT
CTGGACGTCTAACGACCTG -> TGGACGTCTAACGACCTGA
CTGGATGCAGTAGCAACAC -> TGGATGCAGTAGCAACACA
CTGGCATGAACACCGGACA -> TGGCATGAACACCGGACAA
CTGGCGAGGGTCGTGCCAA -> TGGCGAGGGTCGTGCCAAA
CTGGGTAAGGTCCTATTCG -> TGGGTAAGGTCCTATTCGA
CTGTCTGAACCGTGGACCG -> TGTCTGAACCGTGGACCGG
CTGTGACAACGTGCTAGGT -> TGTGACAACGTGCTAGGTC
CTGTGAGTGTGAAGCAGCC -> TGTGAGTGTGAAGCAGCCG
CTGTGCATCGTTCTGTGTC -> TGTGCATCGTTCTGTGTCC
CTGTGCGATACTTTCATCT -> TGTGCGATACTTTCATCTT
CTGTGCTACGATTTCTTTG -> TGTGCTACGATTTCTTTGT
CTGTGTCCCTCTTTCATCG -> TGTGTCCCTCTTTCATCGG
CTGTGTCTTTTGCAGCGCG -> TGTGTCTTTTGCAGCGCGC
CTGTTCGGATGCCGTTAAG -> TGTTCGGATGCCGTTAAGA
CTGTTGACGCACGAGAGAA -> TGTTGACGCACGAGAGAAC
CTGTTGCCCTCGGACGTAA -> TGTTGCCCTCGGACGTAAT
CTTAACGAACGCACAGCAG -> TTAACGAACGCACAGCAGG
CTTAAGGACTTCAGGAGGA -> TTAAGGACTTCAGGAGGAT
CTTAAGGGAGTCGCCACAT -> TTAAGGGAGTCGCCACATT
CTTAATACGTCAACAGGTA -> TTAATACGTCAACAGGTAT
CTTACGTCTGGACGTCTAA -> TTACGTCTGGACGTCTAAC
CTTATGGACACGCGGTGAA -> TTATGGACACGCGGTGAAT
CTTATTTACAATAAGACAG -> TTATTTACAATAAGACAGA
CTTCAAATACGAACCCAGC -> TTCAAATACGAACCCAGCT
CTTCAATCATTACAAGGGT -> TTCAATCATTACAAGGGTG
CTTCAGGAGGATCGCTGCC -> TTCAGGAGGATCGCTGCCA
CTTCAGTTGGGCAGATTTG -> TTCAGTTGGGCAGATTTGC
CTTCATTGTCAAACTGGGT -> TTCATTGTCAAACTGGGTA
CTTCCCATCAAAGATTCTA -> TTCCCATCAAAGATTCTAC
CTTCCGTCAGAACTTTGGA -> TTCCGTCAGAACTTTGGAC
CTTCCTCGTTAGTCTGAGG -> TTCCTCGTTAGTCTGAGGG
CTTGAACGTGCGGTATTCG -> TTGAACGTGCGGTATTCGA
CTTGCAGTATTCTAAGCCT -> TTGCAGTATTCTAAGCCTT
CTTGCGAACCCTATTTCAC -> TTGCGAACCCTATTTCACC
CTTGCGGAGCTGTGAGTGT -> TTGCGGAGCTGTGAGTGTG
CTTGCTTGCGAACCCTATT -> TTGCTTGCGAACCCTATTT
CTTGGCAGGTACACCTGAT -> TTGGCAGGTACACCTGATC
CTTGGTATATCTCACGTAA -> TTGGTATATCTCACGTAAT
CTTGTCATGCGCACTTATG -> TTGTCATGCGCACTTATGG
CTTGTGGCGGCAATAAGCG -> TTGTGGCGGCAATAAGCGG
CTTGTTAAGTACAGTCGCC -> TTGTTAAGTACAGTCGCCC
CTTGTTTCCACTTAACGAA -> TTGTTTCCACTTAACGAAC
CTTTACCCATACAGCAGCA -> TTTACCCATACAGCAGCAA
CTTTCATCGGTAAGTAGCT -> TTTCATCGGTAAGTAGCTA
CTTTCATCTTCAATCATTA -> TTTCATCTTCAATCATTAC
CTTTCGCAGGAGGTATCTG -> TTTCGCAGGAGGTATCTGT
CTTTCTCGCGGGTGAGGTA -> TTTCTCGCGGGTGAGGTAG
CTTTCTTGCAGTATTCTAA -> TTTCTTGCAGTATTCTAAG
CTTTGCACTGTGACAACGT -> TTTGCACTGTGACAACGTG
CTTTGGACGATATGAACAG -> TTTGGACGATATGAACAGT
CTTTGTGATCTAAACTAGT -> TTTGTGATCTAAACTAGTG
CTTTTGCAGCGCGCGGTCA -> TTTTGCAGCGCGCGGTCAG
CTTTTTCTGTGCTACGATT -> TTTTTCTGTGCTACGATTT
CTTTTTGTCCCACGCCACG -> TTTTTGTCCCACGCCACGA
GAAAACACGAACGAGCAAG -> AAAACACGAACGAGCAAGA
GAAACGCCATCGTCAGGCA -> AAACGCCATCGTCAGGCAT
GAAAGCTAGGACCATCCAA -> AAAGCTAGGACCATCCAAG
GAAAGCTGCGTAGATAGCA -> AAAGCTGCGTAGATAGCAT
GAACACCGGACAAGAGATG -> AACACCGGACAAGAGATGT
GAACAGTCAAACACCCCAC -> AACAGTCAAACACCCCACT
GAACATAAGAAGTCTTGCG -> AACATAAGAAGTCTTGCGG
GAACATCAGAACGGGATTT -> AACATCAGAACGGGATTTC
GAACCCAGCTGGCATGAAC -> AACCCAGCTGGCATGAACA
GAACCCGCCATCTCAAGAA -> AACCCGCCATCTCAAGAAG
GAACCCTATTTCACCAGGG -> AACCCTATTTCACCAGGGC
GAACCGTGGACCGGCCGAA -> AACCGTGGACCGGCCGAAT
GAACGACTCATAATGCCAG -> AACGACTCATAATGCCAGT
GAACGAGCAAGACACTCTT -> AACGAGCAAGACACTCTTG
GAACGCACAGCAGGACCCA -> AACGCACAGCAGGACCCAG
GAACGCAGCCCGTAGACGA -> AACGCAGCCCGTAGACGAT
GAACGCCCCTACGCCAGTA -> AACGCCCCTACGCCAGTAA
GAACGGGATTTCGGCGGGG -> AACGGGATTTCGGCGGGGC
GAACGTGCGGTATTCGAAT -> AACGTGCGGTATTCGAATT
GAACTTCAAATACGAACCC -> AACTTCAAATACGAACCCA
GAACTTTGGACGATATGAA -> AACTTTGGACGATATGAAC
GAAGAATTTCTCTTTTTCT -> AAGAATTTCTCTTTTTCTG
GAAGCAGCCGATTCTGTGC -> AAGCAGCCGATTCTGTGCA
GAAGGTTGGTCAGGACGGG -> AAGGTTGGTCAGGACGGGC
GAAGTACAAGCTTGCTTGC -> AAGTACAAGCTTGCTTGCG
GAAGTCTTGCGGAGCTGTG -> AAGTCTTGCGGAGCTGTGA
GAAGTTCTAGCCCTCAGCG -> AAGTTCTAGCCCTCAGCGC
GAATGTACGACGCGATAGC -> AATGTACGACGCGATAGCA
GAATGTGGAGATATGGCAC -> AATGTGGAGATATGGCACC
GAATTAATTTAATATCGGC -> AATTAATTTAATATCGGCA
GAATTGGTCTCAAGGCCCG -> AATTGGTCTCAAGGCCCGC
GAATTTCTCTTTTTCTGTG -> AATTTCTCTTTTTCTGTGC
GACAAACGTACCACAGGTC -> ACAAACGTACCACAGGTCT
GACAACGTAATAATCCGAG -> ACAACGTAATAATCCGAGG
GACAACGTGCTAGGTCAGG -> ACAACGTGCTAGGTCAGGT
GACAAGAGATGTATGTAAG -> ACAAGAGATGTATGTAAGT
GACACAGTGGGTACAACAG -> ACACAGTGGGTACAACAGA
GACACGCGGTGAATGTGGA -> ACACGCGGTGAATGTGGAG
GACACGTAATAATCCGAGG -> ACACGTAATAATCCGAGGT
GACACTCTTGTTTCCACTT -> ACACTCTTGTTTCCACTTA
GACAGACATGACCTTAATA -> ACAGACATGACCTTAATAC
GACAGCGGCAAGTCTGAAC -> ACAGCGGCAAGTCTGAACG
GACAGGCTGTTGACGCACG -> ACAGGCTGTTGACGCACGA
GACATGACCTTAATACGTC -> ACATGACCTTAATACGTCA
GACATGTAGAGCGGTGACG -> ACATGTAGAGCGGTGACGC
GACATTTACGAGTCTTAAG -> ACATTTACGAGTCTTAAGG
GACCACGCTTTCTCGCGGG -> ACCACGCTTTCTCGCGGGT
GACCATCCAAGCAGCATGT -> ACCATCCAAGCAGCATGTC
GACCATGTCACGTGCTTAC -> ACCATGTCACGTGCTTACG
GACCCAGGAGACCATGTCA -> ACCCAGGAGACCATGTCAC
GACCCCACCCCTAACAATT -> ACCCCACCCCTAACAATTG
GACCCGCATGAAAACTCTA -> ACCCGCATGAAAACTCTAA
GACCCGGGAGCTCCACTGT -> ACCCGGGAGCTCCACTGTG
GACCCTCTGGATGCAGTAG -> ACCCTCTGGATGCAGTAGC
GACCGGCCGAATGTACGAC -> ACCGGCCGAATGTACGACG
GACCGTATGGGACACAGTG -> ACCGTATGGGACACAGTGG
GACCTATTTTAGGCGGAAA -> ACCTATTTTAGGCGGAAAG
GACCTGAGAGATGTTCCCT -> ACCTGAGAGATGTTCCCTA
GACCTTAATACGTCAACAG -> ACCTTAATACGTCAACAGG
GACGATATAGGGACTAGAT -> ACGATATAGGGACTAGATG
GACGATATGAACAGTCAAA -> ACGATATGAACAGTCAAAC
GACGCACGAGAGAACGACT -> ACGCACGAGAGAACGACTC
GACGCCATTATCTCCGTGT -> ACGCCATTATCTCCGTGTT
GACGCGATAGCACCCGTAT -> ACGCGATAGCACCCGTATT
GACGGGCAGTCCGCATGGC -> ACGGGCAGTCCGCATGGCC
GACGTAATAATCCGAGGTG -> ACGTAATAATCCGAGGTGT
GACGTCTAACGACCTGAGA -> ACGTCTAACGACCTGAGAG
GACTAGATGGAGTGCCAAT -> ACTAGATGGAGTGCCAATA
GACTCATAATGCCAGTTAC -> ACTCATAATGCCAGTTACT
GACTTCAGGAGGATCGCTG -> ACTTCAGGAGGATCGCTGC
GACTTGTCATGCGCACTTA -> ACTTGTCATGCGCACTTAT
GACTTTACCCATACAGCAG -> ACTTTACCCATACAGCAGC
GACTTTTTGTCCCACGCCA -> ACTTTTTGTCCCACGCCAC
GAGAACGACTCATAATGCC -> AGAACGACTCATAATGCCA
GAGAAGAATTTCTCTTTTT -> AGAAGAATTTCTCTTTTTC
GAGACAAACGTACCACAGG -> AGACAAACGTACCACAGGT
GAGACCATGTCACGTGCTT -> AGACCATGTCACGTGCTTA
GAGAGAACGACTCATAATG -> AGAGAACGACTCATAATGC
GAGAGATGTTCCCTAGGAT -> AGAGATGTTCCCTAGGATC
GAGATATGGCACCAACAGA -> AGATATGGCACCAACAGAG
GAGATGTATGTAAGTAGCT -> AGATGTATGTAAGTAGCTA
GAGATGTTCCCTAGGATCC -> AGATGTTCCCTAGGATCCC
GAGCAAGACACTCTTGTTT -> AGCAAGACACTCTTGTTTC
GAGCGGTGACGCCATTATC -> AGCGGTGACGCCATTATCT
GAGCTCCACTGTGCGATAC -> AGCTCCACTGTGCGATACT
GAGCTGTGAGTGTGAAGCA -> AGCTGTGAGTGTGAAGCAG
GAGCTTCATTGTCAAACTG -> AGCTTCATTGTCAAACTGG
GAGGACCGTATGGGACACA -> AGGACCGTATGGGACACAG
GAGGATCGCTGCCAGCAAG -> AGGATCGCTGCCAGCAAGC
GAGGGATCTCTAGCATCGC -> AGGGATCTCTAGCATCGCG
GAGGGGCTACTACTAATGT -> AGGGGCTACTACTAATGTA
GAGGGGTTAATCTTCCCAT -> AGGGGTTAATCTTCCCATC
GAGGGTCGTGCCAAAGGAC -> AGGGTCGTGCCAAAGGACC
GAGGTAGACCCGCATGAAA -> AGGTAGACCCGCATGAAAA
GAGGTATCTGTCTGAACCG -> AGGTATCTGTCTGAACCGT
GAGGTGAATTAATTTAATA -> AGGTGAATTAATTTAATAT
GAGGTGGGTATACTGATAC -> AGGTGGGTATACTGATACT
GAGGTGTAATGGAGACAAA -> AGGTGTAATGGAGACAAAC
GAGGTGTCAGACCCGGGAG -> AGGTGTCAGACCCGGGAGC
GAGGTGTCCTATACGCAAG -> AGGTGTCCTATACGCAAGT
GAGGTGTGACTTTTTGTCC -> AGGTGTGACTTTTTGTCCC
GAGTAAGTAGCTAGCAATC -> AGTAAGTAGCTAGCAATCT
GAGTACCACTTTGCACTGT -> AGTACCACTTTGCACTGTG
GAGTCGCCACATTCTTCCT -> AGTCGCCACATTCTTCCTC
GAGTCTTAAGGGAGTCGCC -> AGTCTTAAGGGAGTCGCCA
GAGTGCCAATATCTACGTG -> AGTGCCAATATCTACGTGC
GAGTGGCTGCACGCTATAA -> AGTGGCTGCACGCTATAAT
GAGTGTGAAGCAGCCGATT -> AGTGTGAAGCAGCCGATTC
GAGTTAGTCGGTTGAACCC -> AGTTAGTCGGTTGAACCCG
GATACGGGCTCGGGTCTCC -> ATACGGGCTCGGGTCTCCT
GATACTGCACCGAGTGGCT -> ATACTGCACCGAGTGGCTG
GATACTTTCATCTTCAATC -> ATACTTTCATCTTCAATCA
GATAGCACCCGTATTTTAA -> ATAGCACCCGTATTTTAAT
GATAGCATTGCTTGAACGT -> ATAGCATTGCTTGAACGTG
GATATAGGGACTAGATGGA -> ATATAGGGACTAGATGGAG
GATATCACATTGTGGGCGA -> ATATCACATTGTGGGCGAG
GATATGAACAGTCAAACAC -> ATATGAACAGTCAAACACC
GATATGGCACCAACAGAGG -> ATATGGCACCAACAGAGGT
GATCACTACTTTCGCAGGA -> ATCACTACTTTCGCAGGAG
GATCATGTATGACCCCACC -> ATCATGTATGACCCCACCC
GATCCCTTTCTTGCAGTAT -> ATCCCTTTCTTGCAGTATT
GATCGCTGCCAGCAAGCAC -> ATCGCTGCCAGCAAGCACA
GATCTAAACTAGTGTCGCG -> ATCTAAACTAGTGTCGCGA
GATCTCTAGCATCGCGTAA -> ATCTCTAGCATCGCGTAAA
GATGCAGTAGCAACACACA -> ATGCAGTAGCAACACACAC
GATGCAGTGGACCTATTTT -> ATGCAGTGGACCTATTTTA
GATGCATGGAGAAGAATTT -> ATGCATGGAGAAGAATTTC
GATGCCGTTAAGATATCAC -> ATGCCGTTAAGATATCACA
GATGGAGTGCCAATATCTA -> ATGGAGTGCCAATATCTAC
GATGTACAAACTTAAGGAC -> ATGTACAAACTTAAGGACT
GATGTATGTAAGTAGCTAG -> ATGTATGTAAGTAGCTAGC
GATGTTCCCTAGGATCCCT -> ATGTTCCCTAGGATCCCTT
GATTACATAGCGCGAAAGC -> ATTACATAGCGCGAAAGCT
GATTCTACAAGTTGAGGGG -> ATTCTACAAGTTGAGGGGC
GATTCTGTGCATCGTTCTG -> ATTCTGTGCATCGTTCTGT
GATTTCGGCGGGGCCGCGC -> ATTTCGGCGGGGCCGCGCA
GATTTCTTTGTGATCTAAA -> ATTTCTTTGTGATCTAAAC
GATTTGAAGGTTGGTCAGG -> ATTTGAAGGTTGGTCAGGA
GATTTGCGCAGGGATCATG -> ATTTGCGCAGGGATCATGT
GCAAACAGAACATCAGAAC -> CAAACAGAACATCAGAACG
GCAACACACACGAACTTCA -> CAACACACACGAACTTCAA
GCAACCCAGGGGCCTGTGT -> CAACCCAGGGGCCTGTGTC
GCAAGACACTCTTGTTTCC -> CAAGACACTCTTGTTTCCA
GCAAGCAACCCAGGGGCCT -> CAAGCAACCCAGGGGCCTG
GCAAGCACATGGCTTATTT -> CAAGCACATGGCTTATTTA
GCAAGTAACGGCAGTCCTG -> CAAGTAACGGCAGTCCTGC
GCAAGTCTGAACGCCCCTA -> CAAGTCTGAACGCCCCTAC
GCAATAAGCGGACTTGTCA -> CAATAAGCGGACTTGTCAT
GCAATCTATGCCCAGACAA -> CAATCTATGCCCAGACAAC
GCAATCTCATATCGGGACA -> CAATCTCATATCGGGACAC
GCAATCTGTTGCCCTCGGA -> CAATCTGTTGCCCTCGGAC
GCAATCTTGGTATATCTCA -> CAATCTTGGTATATCTCAC
GCAATTAATCAGCAGAAAC -> CAATTAATCAGCAGAAACG
GCACACCCGTTTGACCACG -> CACACCCGTTTGACCACGC
GCACAGCAGGACCCAGGAG -> CACAGCAGGACCCAGGAGA
GCACATGGCTTATTTACAA -> CACATGGCTTATTTACAAT
GCACCAACAGAGGTGGGTA -> CACCAACAGAGGTGGGTAT
GCACCCGTATTTTAATGCC -> CACCCGTATTTTAATGCCC
GCACCGAGTGGCTGCACGC -> CACCGAGTGGCTGCACGCT
GCACGAGAGAACGACTCAT -> CACGAGAGAACGACTCATA
GCACGCTATAATAGAGGTG -> CACGCTATAATAGAGGTGA
GCACGGTGATGCAGTGGAC -> CACGGTGATGCAGTGGACC
GCACTGTGACAACGTGCTA -> CACTGTGACAACGTGCTAG
GCACTTATGGACACGCGGT -> CACTTATGGACACGCGGTG
GCAGAAACGCCATCGTCAG -> CAGAAACGCCATCGTCAGG
GCAGATTTGCGCAGGGATC -> CAGATTTGCGCAGGGATCA
GCAGCAAACAGAACATCAG -> CAGCAAACAGAACATCAGA
GCAGCATGTCACCGGACAG -> CAGCATGTCACCGGACAGC
GCAGCCCGTAGACGATATA -> CAGCCCGTAGACGATATAG
GCAGCCGATTCTGTGCATC -> CAGCCGATTCTGTGCATCG
GCAGCGCGCGGTCAGCGAT -> CAGCGCGCGGTCAGCGATG
GCAGGACCCAGGAGACCAT -> CAGGACCCAGGAGACCATG
GCAGGAGGTATCTGTCTGA -> CAGGAGGTATCTGTCTGAA
GCAGGGATCATGTATGACC -> CAGGGATCATGTATGACCC
GCAGGTACACCTGATCACT -> CAGGTACACCTGATCACTA
GCAGTAGCAACACACACGA -> CAGTAGCAACACACACGAA
GCAGTATTCTAAGCCTTGG -> CAGTATTCTAAGCCTTGGC
GCAGTCCGCATGGCCGGGC -> CAGTCCGCATGGCCGGGCA
GCAGTCCTGCCGTAAGTAG -> CAGTCCTGCCGTAAGTAGC
GCAGTGGACCTATTTTAGG -> CAGTGGACCTATTTTAGGC
GCATCCCCAACTTCCGTCA -> CATCCCCAACTTCCGTCAG
GCATCGCGTAAAGGGTGAG -> CATCGCGTAAAGGGTGAGT
GCATCGGATACGGGCTCGG -> CATCGGATACGGGCTCGGG
GCATCGTTCTGTGTCCCTC -> CATCGTTCTGTGTCCCTCT
GCATGAAAACTCTAAGGAT -> CATGAAAACTCTAAGGATG
GCATGAACACCGGACAAGA -> CATGAACACCGGACAAGAG
GCATGAGGACCGTATGGGA -> CATGAGGACCGTATGGGAC
GCATGGAGAAGAATTTCTC -> CATGGAGAAGAATTTCTCT
GCATGGCAAGCAACCCAGG -> CATGGCAAGCAACCCAGGG
GCATGGCCGGGCACACCCG -> CATGGCCGGGCACACCCGT
GCATGTCACCGGACAGCGG -> CATGTCACCGGACAGCGGC
GCATTGCTTGAACGTGCGG -> CATTGCTTGAACGTGCGGT
GCATTTGAACATAAGAAGT -> CATTTGAACATAAGAAGTC
GCCAAAGGACCCTCTGGAT -> CCAAAGGACCCTCTGGATG
GCCAATATCTACGTGCACG -> CCAATATCTACGTGCACGG
GCCACATTCTTCCTCGTTA -> CCACATTCTTCCTCGTTAG
GCCACGACATTTACGAGTC -> CCACGACATTTACGAGTCT
GCCAGCAAGCACATGGCTT -> CCAGCAAGCACATGGCTTA
GCCAGGAGTAAGTAGCTAG -> CCAGGAGTAAGTAGCTAGC
GCCAGTAAGACATGTAGAG -> CCAGTAAGACATGTAGAGC
GCCAGTTACTCGTCGTTGT -> CCAGTTACTCGTCGTTGTG
GCCATCGTCAGGCATGGCA -> CCATCGTCAGGCATGGCAA
GCCATCTCAAGAAGTACAA -> CCATCTCAAGAAGTACAAG
GCCATTATCTCCGTGTTCT -> CCATTATCTCCGTGTTCTG
GCCCACCCTATCCATCTCA -> CCCACCCTATCCATCTCAC
GCCCAGACAACGTAATAAT -> CCCAGACAACGTAATAATC
GCCCCGTTGCCAGGAGTAA -> CCCCGTTGCCAGGAGTAAG
GCCCCTACGCCAGTAAGAC -> CCCCTACGCCAGTAAGACA
GCCCCTGTTCGGATGCCGT -> CCCCTGTTCGGATGCCGTT
GCCCGCGTCTCCACCTTGT -> CCCGCGTCTCCACCTTGTG
GCCCGTAGACGATATAGGG -> CCCGTAGACGATATAGGGA
GCCCTCAGCGCATCCCCAA -> CCCTCAGCGCATCCCCAAC
GCCCTCGGACGTAATAATC -> CCCTCGGACGTAATAATCC
GCCGAATGTACGACGCGAT -> CCGAATGTACGACGCGATA
GCCGATTCTGTGCATCGTT -> CCGATTCTGTGCATCGTTC
GCCGCGCATCGGATACGGG -> CCGCGCATCGGATACGGGC
GCCGGGCACACCCGTTTGA -> CCGGGCACACCCGTTTGAC
GCCGTAAGTAGCTAGCAAT -> CCGTAAGTAGCTAGCAATC
GCCGTTAAGATATCACATT -> CCGTTAAGATATCACATTG
GCCTGTGTCTTTTGCAGCG -> CCTGTGTCTTTTGCAGCGC
GCCTTGGCAGGTACACCTG -> CCTTGGCAGGTACACCTGA
GCGAAAGCTAGGACCATCC -> CGAAAGCTAGGACCATCCA
GCGAACCCTATTTCACCAG -> CGAACCCTATTTCACCAGG
GCGAAGTTCTAGCCCTCAG -> CGAAGTTCTAGCCCTCAGC
GCGAGGGTCGTGCCAAAGG -> CGAGGGTCGTGCCAAAGGA
GCGAGTTAGTCGGTTGAAC -> CGAGTTAGTCGGTTGAACC
GCGATACTTTCATCTTCAA -> CGATACTTTCATCTTCAAT
GCGATAGCACCCGTATTTT -> CGATAGCACCCGTATTTTA
GCGATGCATGGAGAAGAAT -> CGATGCATGGAGAAGAATT
GCGATGTACAAACTTAAGG -> CGATGTACAAACTTAAGGA
GCGCACTTATGGACACGCG -> CGCACTTATGGACACGCGG
GCGCAGGGATCATGTATGA -> CGCAGGGATCATGTATGAC
GCGCATCCCCAACTTCCGT -> CGCATCCCCAACTTCCGTC
GCGCATCGGATACGGGCTC -> CGCATCGGATACGGGCTCG
GCGCGAAAGCTAGGACCAT -> CGCGAAAGCTAGGACCATC
GCGCGCGGTCAGCGATGCA -> CGCGCGGTCAGCGATGCAT
GCGCGGTCAGCGATGCATG -> CGCGGTCAGCGATGCATGG
GCGGAAAGCTGCGTAGATA -> CGGAAAGCTGCGTAGATAG
GCGGACTTGTCATGCGCAC -> CGGACTTGTCATGCGCACT
GCGGAGCTGTGAGTGTGAA -> CGGAGCTGTGAGTGTGAAG
GCGGCAAGTCTGAACGCCC -> CGGCAAGTCTGAACGCCCC
GCGGCAATAAGCGGACTTG -> CGGCAATAAGCGGACTTGT
GCGGCAATTAATCAGCAGA -> CGGCAATTAATCAGCAGAA
GCGGGGCCGCGCATCGGAT -> CGGGGCCGCGCATCGGATA
GCGGGTGAGGTAGACCCGC -> CGGGTGAGGTAGACCCGCA
GCGGTATTCGAATTGGTCT -> CGGTATTCGAATTGGTCTC
GCGGTCAGCGATGCATGGA -> CGGTCAGCGATGCATGGAG
GCGGTGAATGTGGAGATAT -> CGGTGAATGTGGAGATATG
GCGGTGACGCCATTATCTC -> CGGTGACGCCATTATCTCC
GCGTAAAGGGTGAGTACCA -> CGTAAAGGGTGAGTACCAC
GCGTAGATAGCATTGCTTG -> CGTAGATAGCATTGCTTGA
GCGTCTCCACCTTGTGGCG -> CGTCTCCACCTTGTGGCGG
GCTACGATTTCTTTGTGAT -> CTACGATTTCTTTGTGATC
GCTACTACTAATGTATCCG -> CTACTACTAATGTATCCGA
GCTAGCAATCTATGCCCAG -> CTAGCAATCTATGCCCAGA
GCTAGCAATCTCATATCGG -> CTAGCAATCTCATATCGGG
GCTAGCAATCTGTTGCCCT -> CTAGCAATCTGTTGCCCTC
GCTAGCAATCTTGGTATAT -> CTAGCAATCTTGGTATATC
GCTAGGACCATCCAAGCAG -> CTAGGACCATCCAAGCAGC
GCTAGGTCAGGTGAACGCA -> CTAGGTCAGGTGAACGCAG
GCTATAATAGAGGTGAATT -> CTATAATAGAGGTGAATTA
GCTCCACTGTGCGATACTT -> CTCCACTGTGCGATACTTT
GCTCGGGTCTCCTCCATCG -> CTCGGGTCTCCTCCATCGT
GCTGCACGCTATAATAGAG -> CTGCACGCTATAATAGAGG
GCTGCCAGCAAGCACATGG -> CTGCCAGCAAGCACATGGC
GCTGCCCACCCTATCCATC -> CTGCCCACCCTATCCATCT
GCTGCGTAGATAGCATTGC -> CTGCGTAGATAGCATTGCT
GCTGGCATGAACACCGGAC -> CTGGCATGAACACCGGACA
GCTGTGAGTGTGAAGCAGC -> CTGTGAGTGTGAAGCAGCC
GCTGTTGACGCACGAGAGA -> CTGTTGACGCACGAGAGAA
GCTTACGTCTGGACGTCTA -> CTTACGTCTGGACGTCTAA
GCTTATTTACAATAAGACA -> CTTATTTACAATAAGACAG
GCTTCATTGTCAAACTGGG -> CTTCATTGTCAAACTGGGT
GCTTGAACGTGCGGTATTC -> CTTGAACGTGCGGTATTCG
GCTTGCGAACCCTATTTCA -> CTTGCGAACCCTATTTCAC
GCTTGCTTGCGAACCCTAT -> CTTGCTTGCGAACCCTATT
GCTTTCTCGCGGGTGAGGT -> CTTTCTCGCGGGTGAGGTA
GGAAAACACGAACGAGCAA -> GAAAACACGAACGAGCAAG
GGAAAGCTGCGTAGATAGC -> GAAAGCTGCGTAGATAGCA
GGACAAGAGATGTATGTAA -> GACAAGAGATGTATGTAAG
GGACACAGTGGGTACAACA -> GACACAGTGGGTACAACAG
GGACACGCGGTGAATGTGG -> GACACGCGGTGAATGTGGA
GGACACGTAATAATCCGAG -> GACACGTAATAATCCGAGG
GGACAGCGGCAAGTCTGAA -> GACAGCGGCAAGTCTGAAC
GGACCATCCAAGCAGCATG -> GACCATCCAAGCAGCATGT
GGACCCAGGAGACCATGTC -> GACCCAGGAGACCATGTCA
GGACCCTCTGGATGCAGTA -> GACCCTCTGGATGCAGTAG
GGACCGGCCGAATGTACGA -> GACCGGCCGAATGTACGAC
GGACCGTATGGGACACAGT -> GACCGTATGGGACACAGTG
GGACCTATTTTAGGCGGAA -> GACCTATTTTAGGCGGAAA
GGACGATATGAACAGTCAA -> GACGATATGAACAGTCAAA
GGACGGGCAGTCCGCATGG -> GACGGGCAGTCCGCATGGC
GGACGTAATAATCCGAGGT -> GACGTAATAATCCGAGGTG
GGACGTCTAACGACCTGAG -> GACGTCTAACGACCTGAGA
GGACTAGATGGAGTGCCAA -> GACTAGATGGAGTGCCAAT
GGACTTCAGGAGGATCGCT -> GACTTCAGGAGGATCGCTG
GGACTTGTCATGCGCACTT -> GACTTGTCATGCGCACTTA
GGAGAAGAATTTCTCTTTT -> GAGAAGAATTTCTCTTTTT
GGAGACAAACGTACCACAG -> GAGACAAACGTACCACAGG
GGAGACCATGTCACGTGCT -> GAGACCATGTCACGTGCTT
GGAGATATGGCACCAACAG -> GAGATATGGCACCAACAGA
GGAGCTCCACTGTGCGATA -> GAGCTCCACTGTGCGATAC
GGAGCTGTGAGTGTGAAGC -> GAGCTGTGAGTGTGAAGCA
GGAGGATCGCTGCCAGCAA -> GAGGATCGCTGCCAGCAAG
GGAGGGGTTAATCTTCCCA -> GAGGGGTTAATCTTCCCAT
GGAGGTATCTGTCTGAACC -> GAGGTATCTGTCTGAACCG
GGAGTAAGTAGCTAGCAAT -> GAGTAAGTAGCTAGCAATC
GGAGTCGCCACATTCTTCC -> GAGTCGCCACATTCTTCCT
GGAGTGCCAATATCTACGT -> GAGTGCCAATATCTACGTG
GGATACGGGCTCGGGTCTC -> GATACGGGCTCGGGTCTCC
GGATCATGTATGACCCCAC -> GATCATGTATGACCCCACC
GGATCCCTTTCTTGCAGTA -> GATCCCTTTCTTGCAGTAT
GGATCGCTGCCAGCAAGCA -> GATCGCTGCCAGCAAGCAC
GGATCTCTAGCATCGCGTA -> GATCTCTAGCATCGCGTAA
GGATGCAGTAGCAACACAC -> GATGCAGTAGCAACACACA
GGATGCCGTTAAGATATCA -> GATGCCGTTAAGATATCAC
GGATTTCGGCGGGGCCGCG -> GATTTCGGCGGGGCCGCGC
GGCAAGCAACCCAGGGGCC -> GCAAGCAACCCAGGGGCCT
GGCAAGTCTGAACGCCCCT -> GCAAGTCTGAACGCCCCTA
GGCAATAAGCGGACTTGTC -> GCAATAAGCGGACTTGTCA
GGCAATTAATCAGCAGAAA -> GCAATTAATCAGCAGAAAC
GGCACACCCGTTTGACCAC -> GCACACCCGTTTGACCACG
GGCACCAACAGAGGTGGGT -> GCACCAACAGAGGTGGGTA
GGCAGATTTGCGCAGGGAT -> GCAGATTTGCGCAGGGATC
GGCAGGTACACCTGATCAC -> GCAGGTACACCTGATCACT
GGCAGTCCGCATGGCCGGG -> GCAGTCCGCATGGCCGGGC
GGCAGTCCTGCCGTAAGTA -> GCAGTCCTGCCGTAAGTAG
GGCATGAACACCGGACAAG -> GCATGAACACCGGACAAGA
GGCATGGCAAGCAACCCAG -> GCATGGCAAGCAACCCAGG
GGCATTTGAACATAAGAAG -> GCATTTGAACATAAGAAGT
GGCCCGCGTCTCCACCTTG -> GCCCGCGTCTCCACCTTGT
GGCCGAATGTACGACGCGA -> GCCGAATGTACGACGCGAT
GGCCGCGCATCGGATACGG -> GCCGCGCATCGGATACGGG
GGCCGGGCACACCCGTTTG -> GCCGGGCACACCCGTTTGA
GGCCTGTGTCTTTTGCAGC -> GCCTGTGTCTTTTGCAGCG
GGCGAGGGTCGTGCCAAAG -> GCGAGGGTCGTGCCAAAGG
GGCGAGTTAGTCGGTTGAA -> GCGAGTTAGTCGGTTGAAC
GGCGGAAAGCTGCGTAGAT -> GCGGAAAGCTGCGTAGATA
GGCGGCAATAAGCGGACTT -> GCGGCAATAAGCGGACTTG
GGCGGCAATTAATCAGCAG -> GCGGCAATTAATCAGCAGA
GGCGGGGCCGCGCATCGGA -> GCGGGGCCGCGCATCGGAT
GGCTACTACTAATGTATCC -> GCTACTACTAATGTATCCG
GGCTCGGGTCTCCTCCATC -> GCTCGGGTCTCCTCCATCG
GGCTGCACGCTATAATAGA -> GCTGCACGCTATAATAGAG
GGCTGTTGACGCACGAGAG -> GCTGTTGACGCACGAGAGA
GGCTTATTTACAATAAGAC -> GCTTATTTACAATAAGACA
GGGACACAGTGGGTACAAC -> GGACACAGTGGGTACAACA
GGGACACGTAATAATCCGA -> GGACACGTAATAATCCGAG
GGGACTAGATGGAGTGCCA -> GGACTAGATGGAGTGCCAA
GGGAGCTCCACTGTGCGAT -> GGAGCTCCACTGTGCGATA
GGGAGTCGCCACATTCTTC -> GGAGTCGCCACATTCTTCC
GGGATCATGTATGACCCCA -> GGATCATGTATGACCCCAC
GGGATCTCTAGCATCGCGT -> GGATCTCTAGCATCGCGTA
GGGATTTCGGCGGGGCCGC -> GGATTTCGGCGGGGCCGCG
GGGCACACCCGTTTGACCA -> GGCACACCCGTTTGACCAC
GGGCAGATTTGCGCAGGGA -> GGCAGATTTGCGCAGGGAT
GGGCAGTCCGCATGGCCGG -> GGCAGTCCGCATGGCCGGG
GGGCCGCGCATCGGATACG -> GGCCGCGCATCGGATACGG
GGGCCTGTGTCTTTTGCAG -> GGCCTGTGTCTTTTGCAGC
GGGCGAGTTAGTCGGTTGA -> GGCGAGTTAGTCGGTTGAA
GGGCGGCAATTAATCAGCA -> GGCGGCAATTAATCAGCAG
GGGCTACTACTAATGTATC -> GGCTACTACTAATGTATCC
GGGCTCGGGTCTCCTCCAT -> GGCTCGGGTCTCCTCCATC
GGGGCCGCGCATCGGATAC -> GGGCCGCGCATCGGATACG
GGGGCCTGTGTCTTTTGCA -> GGGCCTGTGTCTTTTGCAG
GGGGCTACTACTAATGTAT -> GGGCTACTACTAATGTATC
GGGGTTAATCTTCCCATCA -> GGGTTAATCTTCCCATCAA
GGGTAAGGTCCTATTCGAT -> GGTAAGGTCCTATTCGATT
GGGTACAACAGACAGGCTG -> GGTACAACAGACAGGCTGT
GGGTATACTGATACTGCAC -> GGTATACTGATACTGCACC
GGGTCGTGCCAAAGGACCC -> GGTCGTGCCAAAGGACCCT
GGGTCTCCTCCATCGTCTG -> GGTCTCCTCCATCGTCTGG
GGGTGAGGTAGACCCGCAT -> GGTGAGGTAGACCCGCATG
GGGTGAGTACCACTTTGCA -> GGTGAGTACCACTTTGCAC
GGGTGATTACATAGCGCGA -> GGTGATTACATAGCGCGAA
GGGTTAATCTTCCCATCAA -> GGTTAATCTTCCCATCAAA
GGGTTCGTTCAAGCGATGT -> GGTTCGTTCAAGCGATGTA
GGTAAGGTCCTATTCGATT -> GTAAGGTCCTATTCGATTT
GGTAAGTAGCTAGCAATCT -> GTAAGTAGCTAGCAATCTG
GGTACAACAGACAGGCTGT -> GTACAACAGACAGGCTGTT
GGTACACCTGATCACTACT -> GTACACCTGATCACTACTT
GGTAGACCCGCATGAAAAC -> GTAGACCCGCATGAAAACT
GGTATACTGATACTGCACC -> GTATACTGATACTGCACCG
GGTATATCTCACGTAATAA -> GTATATCTCACGTAATAAT
GGTATCACCCGAGCTTCAT -> GTATCACCCGAGCTTCATT
GGTATCTGTCTGAACCGTG -> GTATCTGTCTGAACCGTGG
GGTATTCGAATTGGTCTCA -> GTATTCGAATTGGTCTCAA
GGTCAGCGATGCATGGAGA -> GTCAGCGATGCATGGAGAA
GGTCAGGACGGGCAGTCCG -> GTCAGGACGGGCAGTCCGC
GGTCAGGTGAACGCAGCCC -> GTCAGGTGAACGCAGCCCG
GGTCCTATTCGATTTGAAG -> GTCCTATTCGATTTGAAGG
GGTCGTGCCAAAGGACCCT -> GTCGTGCCAAAGGACCCTC
GGTCTACGTGGGTTCGTTC -> GTCTACGTGGGTTCGTTCA
GGTCTCAAGGCCCGCGTCT -> GTCTCAAGGCCCGCGTCTC
GGTCTCCTCCATCGTCTGG -> GTCTCCTCCATCGTCTGGC
GGTGAACGCAGCCCGTAGA -> GTGAACGCAGCCCGTAGAC
GGTGAATGTGGAGATATGG -> GTGAATGTGGAGATATGGC
GGTGAATTAATTTAATATC -> GTGAATTAATTTAATATCG
GGTGACGCCATTATCTCCG -> GTGACGCCATTATCTCCGT
GGTGAGGTAGACCCGCATG -> GTGAGGTAGACCCGCATGA
GGTGAGTACCACTTTGCAC -> GTGAGTACCACTTTGCACT
GGTGATGCAGTGGACCTAT -> GTGATGCAGTGGACCTATT
GGTGATTACATAGCGCGAA -> GTGATTACATAGCGCGAAA
GGTGGGTATACTGATACTG -> GTGGGTATACTGATACTGC
GGTGTAATGGAGACAAACG -> GTGTAATGGAGACAAACGT
GGTGTCAGACCCGGGAGCT -> GTGTCAGACCCGGGAGCTC
GGTGTCCTATACGCAAGTA -> GTGTCCTATACGCAAGTAA
GGTGTGACTTTTTGTCCCA -> GTGTGACTTTTTGTCCCAC
GGTTAATCTTCCCATCAAA -> GTTAATCTTCCCATCAAAG
GGTTCGTTCAAGCGATGTA -> GTTCGTTCAAGCGATGTAC
GGTTGAACCCGCCATCTCA -> GTTGAACCCGCCATCTCAA
GGTTGGTCAGGACGGGCAG -> GTTGGTCAGGACGGGCAGT
GTAAAGGGTGAGTACCACT -> TAAAGGGTGAGTACCACTT
GTAACGGCAGTCCTGCCGT -> TAACGGCAGTCCTGCCGTA
GTAAGACATGTAGAGCGGT -> TAAGACATGTAGAGCGGTG
GTAAGGTCCTATTCGATTT -> TAAGGTCCTATTCGATTTG
GTAAGTAGCTAGCAATCTA -> TAAGTAGCTAGCAATCTAT
GTAAGTAGCTAGCAATCTC -> TAAGTAGCTAGCAATCTCA
GTAAGTAGCTAGCAATCTG -> TAAGTAGCTAGCAATCTGT
GTAAGTAGCTAGCAATCTT -> TAAGTAGCTAGCAATCTTG
GTAATAATCCGAGGTGTAA -> TAATAATCCGAGGTGTAAT
GTAATAATCCGAGGTGTCA -> TAATAATCCGAGGTGTCAG
GTAATAATCCGAGGTGTCC -> TAATAATCCGAGGTGTCCT
GTAATAATCCGAGGTGTGA -> TAATAATCCGAGGTGTGAC
GTAATGGAGACAAACGTAC -> TAATGGAGACAAACGTACC
GTACAAACTTAAGGACTTC -> TACAAACTTAAGGACTTCA
GTACAACAGACAGGCTGTT -> TACAACAGACAGGCTGTTG
GTACAAGCTTGCTTGCGAA -> TACAAGCTTGCTTGCGAAC
GTACACCTGATCACTACTT -> TACACCTGATCACTACTTT
GTACAGTCGCCCCGTTGCC -> TACAGTCGCCCCGTTGCCA
GTACCACAGGTCTACGTGG -> TACCACAGGTCTACGTGGG
GTACCACTTTGCACTGTGA -> TACCACTTTGCACTGTGAC
GTACGACGCGATAGCACCC -> TACGACGCGATAGCACCCG
GTAGACCCGCATGAAAACT -> TAGACCCGCATGAAAACTC
GTAGACGATATAGGGACTA -> TAGACGATATAGGGACTAG
GTAGAGCGGTGACGCCATT -> TAGAGCGGTGACGCCATTA
GTAGATAGCATTGCTTGAA -> TAGATAGCATTGCTTGAAC
GTAGCAACACACACGAACT -> TAGCAACACACACGAACTT
GTAGCTAGCAATCTATGCC -> TAGCTAGCAATCTATGCCC
GTAGCTAGCAATCTCATAT -> TAGCTAGCAATCTCATATC
GTAGCTAGCAATCTGTTGC -> TAGCTAGCAATCTGTTGCC
GTAGCTAGCAATCTTGGTA -> TAGCTAGCAATCTTGGTAT
GTATACTGATACTGCACCG -> TATACTGATACTGCACCGA
GTATATCTCACGTAATAAT -> TATATCTCACGTAATAATC
GTATCACCCGAGCTTCATT -> TATCACCCGAGCTTCATTG
GTATCCGACTTTACCCATA -> TATCCGACTTTACCCATAC
GTATCTGTCTGAACCGTGG -> TATCTGTCTGAACCGTGGA
GTATGACCCCACCCCTAAC -> TATGACCCCACCCCTAACA
GTATGGGACACAGTGGGTA -> TATGGGACACAGTGGGTAC
GTATGTAAGTAGCTAGCAA -> TATGTAAGTAGCTAGCAAT
GTATTCGAATTGGTCTCAA -> TATTCGAATTGGTCTCAAG
GTATTCTAAGCCTTGGCAG -> TATTCTAAGCCTTGGCAGG
GTATTTTAATGCCCCTGTT -> TATTTTAATGCCCCTGTTC
GTCAAACACCCCACTTGTT -> TCAAACACCCCACTTGTTA
GTCAAACTGGGTAAGGTCC -> TCAAACTGGGTAAGGTCCT
GTCAACAGGTATCACCCGA -> TCAACAGGTATCACCCGAG
GTCACCGGACAGCGGCAAG -> TCACCGGACAGCGGCAAGT
GTCACGTGCTTACGTCTGG -> TCACGTGCTTACGTCTGGA
GTCAGAACTTTGGACGATA -> TCAGAACTTTGGACGATAT
GTCAGACCCGGGAGCTCCA -> TCAGACCCGGGAGCTCCAC
GTCAGCGATGCATGGAGAA -> TCAGCGATGCATGGAGAAG
GTCAGGACGGGCAGTCCGC -> TCAGGACGGGCAGTCCGCA
GTCAGGCATGGCAAGCAAC -> TCAGGCATGGCAAGCAACC
GTCAGGTGAACGCAGCCCG -> TCAGGTGAACGCAGCCCGT
GTCATGCGCACTTATGGAC -> TCATGCGCACTTATGGACA
GTCCCACGCCACGACATTT -> TCCCACGCCACGACATTTA
GTCCCTCTTTCATCGGTAA -> TCCCTCTTTCATCGGTAAG
GTCCGCATGGCCGGGCACA -> TCCGCATGGCCGGGCACAC
GTCCTATACGCAAGTAACG -> TCCTATACGCAAGTAACGG
GTCCTATTCGATTTGAAGG -> TCCTATTCGATTTGAAGGT
GTCCTGCCGTAAGTAGCTA -> TCCTGCCGTAAGTAGCTAG
GTCGCCACATTCTTCCTCG -> TCGCCACATTCTTCCTCGT
GTCGCCCCGTTGCCAGGAG -> TCGCCCCGTTGCCAGGAGT
GTCGCGAAGTTCTAGCCCT -> TCGCGAAGTTCTAGCCCTC
GTCGGTTGAACCCGCCATC -> TCGGTTGAACCCGCCATCT
GTCGTGCCAAAGGACCCTC -> TCGTGCCAAAGGACCCTCT
GTCGTTGTGGAGGGGTTAA -> TCGTTGTGGAGGGGTTAAT
GTCTAACGACCTGAGAGAT -> TCTAACGACCTGAGAGATG
GTCTACGTGGGTTCGTTCA -> TCTACGTGGGTTCGTTCAA
GTCTCAAGGCCCGCGTCTC -> TCTCAAGGCCCGCGTCTCC
GTCTCCACCTTGTGGCGGC -> TCTCCACCTTGTGGCGGCA
GTCTCCTCCATCGTCTGGC -> TCTCCTCCATCGTCTGGCG
GTCTGAACCGTGGACCGGC -> TCTGAACCGTGGACCGGCC
GTCTGAACGCCCCTACGCC -> TCTGAACGCCCCTACGCCA
GTCTGAGGGATCTCTAGCA -> TCTGAGGGATCTCTAGCAT
GTCTGGACGTCTAACGACC -> TCTGGACGTCTAACGACCT
GTCTGGCGAGGGTCGTGCC -> TCTGGCGAGGGTCGTGCCA
GTCTTAAGGGAGTCGCCAC -> TCTTAAGGGAGTCGCCACA
GTCTTGCGGAGCTGTGAGT -> TCTTGCGGAGCTGTGAGTG
GTCTTTTGCAGCGCGCGGT -> TCTTTTGCAGCGCGCGGTC
GTGAACGCAGCCCGTAGAC -> TGAACGCAGCCCGTAGACG
GTGAAGCAGCCGATTCTGT -> TGAAGCAGCCGATTCTGTG
GTGAATGTGGAGATATGGC -> TGAATGTGGAGATATGGCA
GTGAATTAATTTAATATCG -> TGAATTAATTTAATATCGG
GTGACAACGTGCTAGGTCA -> TGACAACGTGCTAGGTCAG
GTGACGCCATTATCTCCGT -> TGACGCCATTATCTCCGTG
GTGACTTTTTGTCCCACGC -> TGACTTTTTGTCCCACGCC
GTGAGGTAGACCCGCATGA -> TGAGGTAGACCCGCATGAA
GTGAGTACCACTTTGCACT -> TGAGTACCACTTTGCACTG
GTGAGTGTGAAGCAGCCGA -> TGAGTGTGAAGCAGCCGAT
GTGATCTAAACTAGTGTCG -> TGATCTAAACTAGTGTCGC
GTGATGCAGTGGACCTATT -> TGATGCAGTGGACCTATTT
GTGATTACATAGCGCGAAA -> TGATTACATAGCGCGAAAG
GTGCACGGTGATGCAGTGG -> TGCACGGTGATGCAGTGGA
GTGCATCGTTCTGTGTCCC -> TGCATCGTTCTGTGTCCCT
GTGCCAAAGGACCCTCTGG -> TGCCAAAGGACCCTCTGGA
GTGCCAATATCTACGTGCA -> TGCCAATATCTACGTGCAC
GTGCGATACTTTCATCTTC -> TGCGATACTTTCATCTTCA
GTGCGGTATTCGAATTGGT -> TGCGGTATTCGAATTGGTC
GTGCTACGATTTCTTTGTG -> TGCTACGATTTCTTTGTGA
GTGCTAGGTCAGGTGAACG -> TGCTAGGTCAGGTGAACGC
GTGCTTACGTCTGGACGTC -> TGCTTACGTCTGGACGTCT
GTGGACCGGCCGAATGTAC -> TGGACCGGCCGAATGTACG
GTGGACCTATTTTAGGCGG -> TGGACCTATTTTAGGCGGA
GTGGAGATATGGCACCAAC -> TGGAGATATGGCACCAACA
GTGGAGGGGTTAATCTTCC -> TGGAGGGGTTAATCTTCCC
GTGGCGGCAATAAGCGGAC -> TGGCGGCAATAAGCGGACT
GTGGCTGCACGCTATAATA -> TGGCTGCACGCTATAATAG
GTGGGCGAGTTAGTCGGTT -> TGGGCGAGTTAGTCGGTTG
GTGGGTACAACAGACAGGC -> TGGGTACAACAGACAGGCT
GTGGGTATACTGATACTGC -> TGGGTATACTGATACTGCA
GTGGGTTCGTTCAAGCGAT -> TGGGTTCGTTCAAGCGATG
GTGTAATGGAGACAAACGT -> TGTAATGGAGACAAACGTA
GTGTCAGACCCGGGAGCTC -> TGTCAGACCCGGGAGCTCC
GTGTCCCTCTTTCATCGGT -> TGTCCCTCTTTCATCGGTA
GTGTCCTATACGCAAGTAA -> TGTCCTATACGCAAGTAAC
GTGTCGCGAAGTTCTAGCC -> TGTCGCGAAGTTCTAGCCC
GTGTCTTTTGCAGCGCGCG -> TGTCTTTTGCAGCGCGCGG
GTGTGAAGCAGCCGATTCT -> TGTGAAGCAGCCGATTCTG
GTGTGACTTTTTGTCCCAC -> TGTGACTTTTTGTCCCACG
GTGTTCTGCATGAGGACCG -> TGTTCTGCATGAGGACCGT
GTTAAGATATCACATTGTG -> TTAAGATATCACATTGTGG
GTTAAGTACAGTCGCCCCG -> TTAAGTACAGTCGCCCCGT
GTTAATCTTCCCATCAAAG -> TTAATCTTCCCATCAAAGA
GTTACTCGTCGTTGTGGAG -> TTACTCGTCGTTGTGGAGG
GTTAGTCGGTTGAACCCGC -> TTAGTCGGTTGAACCCGCC
GTTAGTCTGAGGGATCTCT -> TTAGTCTGAGGGATCTCTA
GTTCAAGCGATGTACAAAC -> TTCAAGCGATGTACAAACT
GTTCCCTAGGATCCCTTTC -> TTCCCTAGGATCCCTTTCT
GTTCGGATGCCGTTAAGAT -> TTCGGATGCCGTTAAGATA
GTTCGTTCAAGCGATGTAC -> TTCGTTCAAGCGATGTACA
GTTCTAGCCCTCAGCGCAT -> TTCTAGCCCTCAGCGCATC
GTTCTGCATGAGGACCGTA -> TTCTGCATGAGGACCGTAT
GTTCTGTGTCCCTCTTTCA -> TTCTGTGTCCCTCTTTCAT
GTTGAACCCGCCATCTCAA -> TTGAACCCGCCATCTCAAG
GTTGACGCACGAGAGAACG -> TTGACGCACGAGAGAACGA
GTTGAGGGGCTACTACTAA -> TTGAGGGGCTACTACTAAT
GTTGCCAGGAGTAAGTAGC -> TTGCCAGGAGTAAGTAGCT
GTTGCCCTCGGACGTAATA -> TTGCCCTCGGACGTAATAA
GTTGGGCAGATTTGCGCAG -> TTGGGCAGATTTGCGCAGG
GTTGGTCAGGACGGGCAGT -> TTGGTCAGGACGGGCAGTC
GTTGTGGAGGGGTTAATCT -> TTGTGGAGGGGTTAATCTT
GTTTCCACTTAACGAACGC -> TTTCCACTTAACGAACGCA
GTTTGACCACGCTTTCTCG -> TTTGACCACGCTTTCTCGC
TAAACTAGTGTCGCGAAGT -> AAACTAGTGTCGCGAAGTT
TAAAGGGTGAGTACCACTT -> AAAGGGTGAGTACCACTTT
TAACAATTGGAAAACACGA -> AACAATTGGAAAACACGAA
TAACGAACGCACAGCAGGA -> AACGAACGCACAGCAGGAC
TAACGACCTGAGAGATGTT -> AACGACCTGAGAGATGTTC
TAACGGCAGTCCTGCCGTA -> AACGGCAGTCCTGCCGTAA
TAAGAAGTCTTGCGGAGCT -> AAGAAGTCTTGCGGAGCTG
TAAGACAGACATGACCTTA -> AAGACAGACATGACCTTAA
TAAGACATGTAGAGCGGTG -> AAGACATGTAGAGCGGTGA
TAAGATATCACATTGTGGG -> AAGATATCACATTGTGGGC
TAAGCCTTGGCAGGTACAC -> AAGCCTTGGCAGGTACACC
TAAGCGGACTTGTCATGCG -> AAGCGGACTTGTCATGCGC
TAAGGACTTCAGGAGGATC -> AAGGACTTCAGGAGGATCG
TAAGGGAGTCGCCACATTC -> AAGGGAGTCGCCACATTCT
TAAGGTCCTATTCGATTTG -> AAGGTCCTATTCGATTTGA
TAAGTACAGTCGCCCCGTT -> AAGTACAGTCGCCCCGTTG
TAAGTAGCTAGCAATCTAT -> AAGTAGCTAGCAATCTATG
TAAGTAGCTAGCAATCTCA -> AAGTAGCTAGCAATCTCAT
TAAGTAGCTAGCAATCTGT -> AAGTAGCTAGCAATCTGTT
TAAGTAGCTAGCAATCTTG -> AAGTAGCTAGCAATCTTGG
TAATAATCCGAGGTGTAAT -> AATAATCCGAGGTGTAATG
TAATAATCCGAGGTGTCAG -> AATAATCCGAGGTGTCAGA
TAATAATCCGAGGTGTCCT -> AATAATCCGAGGTGTCCTA
TAATAATCCGAGGTGTGAC -> AATAATCCGAGGTGTGACT
TAATACGTCAACAGGTATC -> AATACGTCAACAGGTATCA
TAATAGAGGTGAATTAATT -> AATAGAGGTGAATTAATTT
TAATATCGGCATTTGAACA -> AATATCGGCATTTGAACAT
TAATCAGCAGAAACGCCAT -> AATCAGCAGAAACGCCATC
TAATCCGAGGTGTAATGGA -> AATCCGAGGTGTAATGGAG
TAATCCGAGGTGTCAGACC -> AATCCGAGGTGTCAGACCC
TAATCCGAGGTGTCCTATA -> AATCCGAGGTGTCCTATAC
TAATCCGAGGTGTGACTTT -> AATCCGAGGTGTGACTTTT
TAATCTTCCCATCAAAGAT -> AATCTTCCCATCAAAGATT
TAATGCCAGTTACTCGTCG -> AATGCCAGTTACTCGTCGT
TAATGCCCCTGTTCGGATG -> AATGCCCCTGTTCGGATGC
TAATGGAGACAAACGTACC -> AATGGAGACAAACGTACCA
TAATGTATCCGACTTTACC -> AATGTATCCGACTTTACCC
TAATTTAATATCGGCATTT -> AATTTAATATCGGCATTTG
TACAAACTTAAGGACTTCA -> ACAAACTTAAGGACTTCAG
TACAACAGACAGGCTGTTG -> ACAACAGACAGGCTGTTGA
TACAAGCTTGCTTGCGAAC -> ACAAGCTTGCTTGCGAACC
TACAAGGGTGATTACATAG -> ACAAGGGTGATTACATAGC
TACAAGTTGAGGGGCTACT -> ACAAGTTGAGGGGCTACTA
TACAATAAGACAGACATGA -> ACAATAAGACAGACATGAC
TACACCTGATCACTACTTT -> ACACCTGATCACTACTTTC
TACAGCAGCAAACAGAACA -> ACAGCAGCAAACAGAACAT
TACAGTCGCCCCGTTGCCA -> ACAGTCGCCCCGTTGCCAG
TACATAGCGCGAAAGCTAG -> ACATAGCGCGAAAGCTAGG
TACCACAGGTCTACGTGGG -> ACCACAGGTCTACGTGGGT
TACCACTTTGCACTGTGAC -> ACCACTTTGCACTGTGACA
TACCCATACAGCAGCAAAC -> ACCCATACAGCAGCAAACA
TACGAACCCAGCTGGCATG -> ACGAACCCAGCTGGCATGA
TACGACGCGATAGCACCCG -> ACGACGCGATAGCACCCGT
TACGAGTCTTAAGGGAGTC -> ACGAGTCTTAAGGGAGTCG
TACGATTTCTTTGTGATCT -> ACGATTTCTTTGTGATCTA
TACGCAAGTAACGGCAGTC -> ACGCAAGTAACGGCAGTCC
TACGCCAGTAAGACATGTA -> ACGCCAGTAAGACATGTAG
TACGGGCTCGGGTCTCCTC -> ACGGGCTCGGGTCTCCTCC
TACGTCAACAGGTATCACC -> ACGTCAACAGGTATCACCC
TACGTCTGGACGTCTAACG -> ACGTCTGGACGTCTAACGA
TACGTGCACGGTGATGCAG -> ACGTGCACGGTGATGCAGT
TACGTGGGTTCGTTCAAGC -> ACGTGGGTTCGTTCAAGCG
TACTAATGTATCCGACTTT -> ACTAATGTATCCGACTTTA
TACTACTAATGTATCCGAC -> ACTACTAATGTATCCGACT
TACTCGTCGTTGTGGAGGG -> ACTCGTCGTTGTGGAGGGG
TACTGATACTGCACCGAGT -> ACTGATACTGCACCGAGTG
TACTGCACCGAGTGGCTGC -> ACTGCACCGAGTGGCTGCA
TACTTTCATCTTCAATCAT -> ACTTTCATCTTCAATCATT
TACTTTCGCAGGAGGTATC -> ACTTTCGCAGGAGGTATCT
TAGACCCGCATGAAAACTC -> AGACCCGCATGAAAACTCT
TAGACGATATAGGGACTAG -> AGACGATATAGGGACTAGA
TAGAGCGGTGACGCCATTA -> AGAGCGGTGACGCCATTAT
TAGAGGTGAATTAATTTAA -> AGAGGTGAATTAATTTAAT
TAGATAGCATTGCTTGAAC -> AGATAGCATTGCTTGAACG
TAGATGGAGTGCCAATATC -> AGATGGAGTGCCAATATCT
TAGCAACACACACGAACTT -> AGCAACACACACGAACTTC
TAGCAATCTATGCCCAGAC -> AGCAATCTATGCCCAGACA
TAGCAATCTCATATCGGGA -> AGCAATCTCATATCGGGAC
TAGCAATCTGTTGCCCTCG -> AGCAATCTGTTGCCCTCGG
TAGCAATCTTGGTATATCT -> AGCAATCTTGGTATATCTC
TAGCACCCGTATTTTAATG -> AGCACCCGTATTTTAATGC
TAGCATCGCGTAAAGGGTG -> AGCATCGCGTAAAGGGTGA
TAGCATTGCTTGAACGTGC -> AGCATTGCTTGAACGTGCG
TAGCCCTCAGCGCATCCCC -> AGCCCTCAGCGCATCCCCA
TAGCGCGAAAGCTAGGACC -> AGCGCGAAAGCTAGGACCA
TAGCTAGCAATCTATGCCC -> AGCTAGCAATCTATGCCCA
TAGCTAGCAATCTCATATC -> AGCTAGCAATCTCATATCG
TAGCTAGCAATCTGTTGCC -> AGCTAGCAATCTGTTGCCC
TAGCTAGCAATCTTGGTAT -> AGCTAGCAATCTTGGTATA
TAGGACCATCCAAGCAGCA -> AGGACCATCCAAGCAGCAT
TAGGATCCCTTTCTTGCAG -> AGGATCCCTTTCTTGCAGT
TAGGCGGAAAGCTGCGTAG -> AGGCGGAAAGCTGCGTAGA
TAGGGACTAGATGGAGTGC -> AGGGACTAGATGGAGTGCC
TAGGTCAGGTGAACGCAGC -> AGGTCAGGTGAACGCAGCC
TAGTCGGTTGAACCCGCCA -> AGTCGGTTGAACCCGCCAT
TAGTCTGAGGGATCTCTAG -> AGTCTGAGGGATCTCTAGC
TAGTGTCGCGAAGTTCTAG -> AGTGTCGCGAAGTTCTAGC
TATAATAGAGGTGAATTAA -> ATAATAGAGGTGAATTAAT
TATACGCAAGTAACGGCAG -> ATACGCAAGTAACGGCAGT
TATACTGATACTGCACCGA -> ATACTGATACTGCACCGAG
TATAGGGACTAGATGGAGT -> ATAGGGACTAGATGGAGTG
TATATCTCACGTAATAATC -> ATATCTCACGTAATAATCC
TATCACATTGTGGGCGAGT -> ATCACATTGTGGGCGAGTT
TATCACCCGAGCTTCATTG -> ATCACCCGAGCTTCATTGT
TATCCATCTCACTCTTCAG -> ATCCATCTCACTCTTCAGT
TATCCGACTTTACCCATAC -> ATCCGACTTTACCCATACA
TATCGGCATTTGAACATAA -> ATCGGCATTTGAACATAAG
TATCGGGACACGTAATAAT -> ATCGGGACACGTAATAATC
TATCTACGTGCACGGTGAT -> ATCTACGTGCACGGTGATG
TATCTCACGTAATAATCCG -> ATCTCACGTAATAATCCGA
TATCTCCGTGTTCTGCATG -> ATCTCCGTGTTCTGCATGA
TATCTGTCTGAACCGTGGA -> ATCTGTCTGAACCGTGGAC
TATGAACAGTCAAACACCC -> ATGAACAGTCAAACACCCC
TATGACCCCACCCCTAACA -> ATGACCCCACCCCTAACAA
TATGCCCAGACAACGTAAT -> ATGCCCAGACAACGTAATA
TATGGACACGCGGTGAATG -> ATGGACACGCGGTGAATGT
TATGGCACCAACAGAGGTG -> ATGGCACCAACAGAGGTGG
TATGGGACACAGTGGGTAC -> ATGGGACACAGTGGGTACA
TATGTAAGTAGCTAGCAAT -> ATGTAAGTAGCTAGCAATC
TATTCGAATTGGTCTCAAG -> ATTCGAATTGGTCTCAAGG
TATTCGATTTGAAGGTTGG -> ATTCGATTTGAAGGTTGGT
TATTCTAAGCCTTGGCAGG -> ATTCTAAGCCTTGGCAGGT
TATTTACAATAAGACAGAC -> ATTTACAATAAGACAGACA
TATTTCACCAGGGCGGCAA -> ATTTCACCAGGGCGGCAAT
TATTTTAATGCCCCTGTTC -> ATTTTAATGCCCCTGTTCG
TATTTTAGGCGGAAAGCTG -> ATTTTAGGCGGAAAGCTGC
TCAAACACCCCACTTGTTA -> CAAACACCCCACTTGTTAA
TCAAACTGGGTAAGGTCCT -> CAAACTGGGTAAGGTCCTA
TCAAAGATTCTACAAGTTG -> CAAAGATTCTACAAGTTGA
TCAAATACGAACCCAGCTG -> CAAATACGAACCCAGCTGG
TCAACAGGTATCACCCGAG -> CAACAGGTATCACCCGAGC
TCAAGAAGTACAAGCTTGC -> CAAGAAGTACAAGCTTGCT
TCAAGCGATGTACAAACTT -> CAAGCGATGTACAAACTTA
TCAAGGCCCGCGTCTCCAC -> CAAGGCCCGCGTCTCCACC
TCAATCATTACAAGGGTGA -> CAATCATTACAAGGGTGAT
TCACATTGTGGGCGAGTTA -> CACATTGTGGGCGAGTTAG
TCACCAGGGCGGCAATTAA -> CACCAGGGCGGCAATTAAT
TCACCCGAGCTTCATTGTC -> CACCCGAGCTTCATTGTCA
TCACCGGACAGCGGCAAGT -> CACCGGACAGCGGCAAGTC
TCACGTAATAATCCGAGGT -> CACGTAATAATCCGAGGTG
TCACGTGCTTACGTCTGGA -> CACGTGCTTACGTCTGGAC
TCACTACTTTCGCAGGAGG -> CACTACTTTCGCAGGAGGT
TCACTCTTCAGTTGGGCAG -> CACTCTTCAGTTGGGCAGA
TCAGAACGGGATTTCGGCG -> CAGAACGGGATTTCGGCGG
TCAGAACTTTGGACGATAT -> CAGAACTTTGGACGATATG
TCAGACCCGGGAGCTCCAC -> CAGACCCGGGAGCTCCACT
TCAGCAGAAACGCCATCGT -> CAGCAGAAACGCCATCGTC
TCAGCGATGCATGGAGAAG -> CAGCGATGCATGGAGAAGA
TCAGCGCATCCCCAACTTC -> CAGCGCATCCCCAACTTCC
TCAGGACGGGCAGTCCGCA -> CAGGACGGGCAGTCCGCAT
TCAGGAGGATCGCTGCCAG -> CAGGAGGATCGCTGCCAGC
TCAGGCATGGCAAGCAACC -> CAGGCATGGCAAGCAACCC
TCAGGTGAACGCAGCCCGT -> CAGGTGAACGCAGCCCGTA
TCAGTTGGGCAGATTTGCG -> CAGTTGGGCAGATTTGCGC
TCATAATGCCAGTTACTCG -> CATAATGCCAGTTACTCGT
TCATATCGGGACACGTAAT -> CATATCGGGACACGTAATA
TCATCGGTAAGTAGCTAGC -> CATCGGTAAGTAGCTAGCA
TCATCTTCAATCATTACAA -> CATCTTCAATCATTACAAG
TCATGCGCACTTATGGACA -> CATGCGCACTTATGGACAC
TCATGTATGACCCCACCCC -> CATGTATGACCCCACCCCT
TCATTACAAGGGTGATTAC -> CATTACAAGGGTGATTACA
TCATTGTCAAACTGGGTAA -> CATTGTCAAACTGGGTAAG
TCCAAGCAGCATGTCACCG -> CCAAGCAGCATGTCACCGG
TCCACCTTGTGGCGGCAAT -> CCACCTTGTGGCGGCAATA
TCCACTGTGCGATACTTTC -> CCACTGTGCGATACTTTCA
TCCACTTAACGAACGCACA -> CCACTTAACGAACGCACAG
TCCATCGTCTGGCGAGGGT -> CCATCGTCTGGCGAGGGTC
TCCATCTCACTCTTCAGTT -> CCATCTCACTCTTCAGTTG
TCCCACGCCACGACATTTA -> CCCACGCCACGACATTTAC
TCCCATCAAAGATTCTACA -> CCCATCAAAGATTCTACAA
TCCCCAACTTCCGTCAGAA -> CCCCAACTTCCGTCAGAAC
TCCCTAGGATCCCTTTCTT -> CCCTAGGATCCCTTTCTTG
TCCCTCTTTCATCGGTAAG -> CCCTCTTTCATCGGTAAGT
TCCCTTTCTTGCAGTATTC -> CCCTTTCTTGCAGTATTCT
TCCGACTTTACCCATACAG -> CCGACTTTACCCATACAGC
TCCGAGGTGTAATGGAGAC -> CCGAGGTGTAATGGAGACA
TCCGAGGTGTCAGACCCGG -> CCGAGGTGTCAGACCCGGG
TCCGAGGTGTCCTATACGC -> CCGAGGTGTCCTATACGCA
TCCGAGGTGTGACTTTTTG -> CCGAGGTGTGACTTTTTGT
TCCGCATGGCCGGGCACAC -> CCGCATGGCCGGGCACACC
TCCGTCAGAACTTTGGACG -> CCGTCAGAACTTTGGACGA
TCCGTGTTCTGCATGAGGA -> CCGTGTTCTGCATGAGGAC
TCCTATACGCAAGTAACGG -> CCTATACGCAAGTAACGGC
TCCTATTCGATTTGAAGGT -> CCTATTCGATTTGAAGGTT
TCCTCCATCGTCTGGCGAG -> CCTCCATCGTCTGGCGAGG
TCCTCGTTAGTCTGAGGGA -> CCTCGTTAGTCTGAGGGAT
TCCTGCCGTAAGTAGCTAG -> CCTGCCGTAAGTAGCTAGC
TCGAATTGGTCTCAAGGCC -> CGAATTGGTCTCAAGGCCC
TCGATTTGAAGGTTGGTCA -> CGATTTGAAGGTTGGTCAG
TCGCAGGAGGTATCTGTCT -> CGCAGGAGGTATCTGTCTG
TCGCCACATTCTTCCTCGT -> CGCCACATTCTTCCTCGTT
TCGCCCCGTTGCCAGGAGT -> CGCCCCGTTGCCAGGAGTA
TCGCGAAGTTCTAGCCCTC -> CGCGAAGTTCTAGCCCTCA
TCGCGGGTGAGGTAGACCC -> CGCGGGTGAGGTAGACCCG
TCGCGTAAAGGGTGAGTAC -> CGCGTAAAGGGTGAGTACC
TCGCTGCCAGCAAGCACAT -> CGCTGCCAGCAAGCACATG
TCGGACGTAATAATCCGAG -> CGGACGTAATAATCCGAGG
TCGGATACGGGCTCGGGTC -> CGGATACGGGCTCGGGTCT
TCGGATGCCGTTAAGATAT -> CGGATGCCGTTAAGATATC
TCGGCATTTGAACATAAGA -> CGGCATTTGAACATAAGAA
TCGGCGGGGCCGCGCATCG -> CGGCGGGGCCGCGCATCGG
TCGGGACACGTAATAATCC -> CGGGACACGTAATAATCCG
TCGGGTCTCCTCCATCGTC -> CGGGTCTCCTCCATCGTCT
TCGGTAAGTAGCTAGCAAT -> CGGTAAGTAGCTAGCAATC
TCGGTTGAACCCGCCATCT -> CGGTTGAACCCGCCATCTC
TCGTCAGGCATGGCAAGCA -> CGTCAGGCATGGCAAGCAA
TCGTCGTTGTGGAGGGGTT -> CGTCGTTGTGGAGGGGTTA
TCGTCTGGCGAGGGTCGTG -> CGTCTGGCGAGGGTCGTGC
TCGTGCCAAAGGACCCTCT -> CGTGCCAAAGGACCCTCTG
TCGTTAGTCTGAGGGATCT -> CGTTAGTCTGAGGGATCTC
TCGTTCAAGCGATGTACAA -> CGTTCAAGCGATGTACAAA
TCGTTCTGTGTCCCTCTTT -> CGTTCTGTGTCCCTCTTTC
TCGTTGTGGAGGGGTTAAT -> CGTTGTGGAGGGGTTAATC
TCTAAACTAGTGTCGCGAA -> CTAAACTAGTGTCGCGAAG
TCTAACGACCTGAGAGATG -> CTAACGACCTGAGAGATGT
TCTAAGCCTTGGCAGGTAC -> CTAAGCCTTGGCAGGTACA
TCTACAAGTTGAGGGGCTA -> CTACAAGTTGAGGGGCTAC
TCTACGTGCACGGTGATGC -> CTACGTGCACGGTGATGCA
TCTACGTGGGTTCGTTCAA -> CTACGTGGGTTCGTTCAAG
TCTAGCATCGCGTAAAGGG -> CTAGCATCGCGTAAAGGGT
TCTAGCCCTCAGCGCATCC -> CTAGCCCTCAGCGCATCCC
TCTATGCCCAGACAACGTA -> CTATGCCCAGACAACGTAA
TCTCAAGAAGTACAAGCTT -> CTCAAGAAGTACAAGCTTG
TCTCAAGGCCCGCGTCTCC -> CTCAAGGCCCGCGTCTCCA
TCTCACGTAATAATCCGAG -> CTCACGTAATAATCCGAGG
TCTCACTCTTCAGTTGGGC -> CTCACTCTTCAGTTGGGCA
TCTCATATCGGGACACGTA -> CTCATATCGGGACACGTAA
TCTCCACCTTGTGGCGGCA -> CTCCACCTTGTGGCGGCAA
TCTCCGTGTTCTGCATGAG -> CTCCGTGTTCTGCATGAGG
TCTCCTCCATCGTCTGGCG -> CTCCTCCATCGTCTGGCGA
TCTCGCGGGTGAGGTAGAC -> CTCGCGGGTGAGGTAGACC
TCTCTAGCATCGCGTAAAG -> CTCTAGCATCGCGTAAAGG
TCTCTTTTTCTGTGCTACG -> CTCTTTTTCTGTGCTACGA
TCTGAACCGTGGACCGGCC -> CTGAACCGTGGACCGGCCG
TCTGAACGCCCCTACGCCA -> CTGAACGCCCCTACGCCAG
TCTGAGGGATCTCTAGCAT -> CTGAGGGATCTCTAGCATC
TCTGCATGAGGACCGTATG -> CTGCATGAGGACCGTATGG
TCTGGACGTCTAACGACCT -> CTGGACGTCTAACGACCTG
TCTGGATGCAGTAGCAACA -> CTGGATGCAGTAGCAACAC
TCTGGCGAGGGTCGTGCCA -> CTGGCGAGGGTCGTGCCAA
TCTGTCTGAACCGTGGACC -> CTGTCTGAACCGTGGACCG
TCTGTGCATCGTTCTGTGT -> CTGTGCATCGTTCTGTGTC
TCTGTGCTACGATTTCTTT -> CTGTGCTACGATTTCTTTG
TCTGTGTCCCTCTTTCATC -> CTGTGTCCCTCTTTCATCG
TCTGTTGCCCTCGGACGTA -> CTGTTGCCCTCGGACGTAA
TCTTAAGGGAGTCGCCACA -> CTTAAGGGAGTCGCCACAT
TCTTCAATCATTACAAGGG -> CTTCAATCATTACAAGGGT
TCTTCAGTTGGGCAGATTT -> CTTCAGTTGGGCAGATTTG
TCTTCCCATCAAAGATTCT -> CTTCCCATCAAAGATTCTA
TCTTCCTCGTTAGTCTGAG -> CTTCCTCGTTAGTCTGAGG
TCTTGCAGTATTCTAAGCC -> CTTGCAGTATTCTAAGCCT
TCTTGCGGAGCTGTGAGTG -> CTTGCGGAGCTGTGAGTGT
TCTTGGTATATCTCACGTA -> CTTGGTATATCTCACGTAA
TCTTGTTTCCACTTAACGA -> CTTGTTTCCACTTAACGAA
TCTTTCATCGGTAAGTAGC -> CTTTCATCGGTAAGTAGCT
TCTTTGTGATCTAAACTAG -> CTTTGTGATCTAAACTAGT
TCTTTTGCAGCGCGCGGTC -> CTTTTGCAGCGCGCGGTCA
TCTTTTTCTGTGCTACGAT -> CTTTTTCTGTGCTACGATT
TGAAAACTCTAAGGATGGG -> GAAAACTCTAAGGATGGGT
TGAACACCGGACAAGAGAT -> GAACACCGGACAAGAGATG
TGAACAGTCAAACACCCCA -> GAACAGTCAAACACCCCAC
TGAACATAAGAAGTCTTGC -> GAACATAAGAAGTCTTGCG
TGAACCCGCCATCTCAAGA -> GAACCCGCCATCTCAAGAA
TGAACCGTGGACCGGCCGA -> GAACCGTGGACCGGCCGAA
TGAACGCAGCCCGTAGACG -> GAACGCAGCCCGTAGACGA
TGAACGCCCCTACGCCAGT -> GAACGCCCCTACGCCAGTA
TGAACGTGCGGTATTCGAA -> GAACGTGCGGTATTCGAAT
TGAAGCAGCCGATTCTGTG -> GAAGCAGCCGATTCTGTGC
TGAAGGTTGGTCAGGACGG -> GAAGGTTGGTCAGGACGGG
TGAATGTGGAGATATGGCA -> GAATGTGGAGATATGGCAC
TGAATTAATTTAATATCGG -> GAATTAATTTAATATCGGC
TGACAACGTGCTAGGTCAG -> GACAACGTGCTAGGTCAGG
TGACCACGCTTTCTCGCGG -> GACCACGCTTTCTCGCGGG
TGACCCCACCCCTAACAAT -> GACCCCACCCCTAACAATT
TGACCTTAATACGTCAACA -> GACCTTAATACGTCAACAG
TGACGCACGAGAGAACGAC -> GACGCACGAGAGAACGACT
TGACGCCATTATCTCCGTG -> GACGCCATTATCTCCGTGT
TGACTTTTTGTCCCACGCC -> GACTTTTTGTCCCACGCCA
TGAGAGATGTTCCCTAGGA -> GAGAGATGTTCCCTAGGAT
TGAGGACCGTATGGGACAC -> GAGGACCGTATGGGACACA
TGAGGGATCTCTAGCATCG -> GAGGGATCTCTAGCATCGC
TGAGGGGCTACTACTAATG -> GAGGGGCTACTACTAATGT
TGAGGTAGACCCGCATGAA -> GAGGTAGACCCGCATGAAA
TGAGTACCACTTTGCACTG -> GAGTACCACTTTGCACTGT
TGAGTGTGAAGCAGCCGAT -> GAGTGTGAAGCAGCCGATT
TGATACTGCACCGAGTGGC -> GATACTGCACCGAGTGGCT
TGATCACTACTTTCGCAGG -> GATCACTACTTTCGCAGGA
TGATCTAAACTAGTGTCGC -> GATCTAAACTAGTGTCGCG
TGATGCAGTGGACCTATTT -> GATGCAGTGGACCTATTTT
TGATTACATAGCGCGAAAG -> GATTACATAGCGCGAAAGC
TGCACCGAGTGGCTGCACG -> GCACCGAGTGGCTGCACGC
TGCACGCTATAATAGAGGT -> GCACGCTATAATAGAGGTG
TGCACGGTGATGCAGTGGA -> GCACGGTGATGCAGTGGAC
TGCACTGTGACAACGTGCT -> GCACTGTGACAACGTGCTA
TGCAGCGCGCGGTCAGCGA -> GCAGCGCGCGGTCAGCGAT
TGCAGTAGCAACACACACG -> GCAGTAGCAACACACACGA
TGCAGTATTCTAAGCCTTG -> GCAGTATTCTAAGCCTTGG
TGCAGTGGACCTATTTTAG -> GCAGTGGACCTATTTTAGG
TGCATCGTTCTGTGTCCCT -> GCATCGTTCTGTGTCCCTC
TGCATGAGGACCGTATGGG -> GCATGAGGACCGTATGGGA
TGCATGGAGAAGAATTTCT -> GCATGGAGAAGAATTTCTC
TGCCAAAGGACCCTCTGGA -> GCCAAAGGACCCTCTGGAT
TGCCAATATCTACGTGCAC -> GCCAATATCTACGTGCACG
TGCCAGCAAGCACATGGCT -> GCCAGCAAGCACATGGCTT
TGCCAGGAGTAAGTAGCTA -> GCCAGGAGTAAGTAGCTAG
TGCCAGTTACTCGTCGTTG -> GCCAGTTACTCGTCGTTGT
TGCCCACCCTATCCATCTC -> GCCCACCCTATCCATCTCA
TGCCCAGACAACGTAATAA -> GCCCAGACAACGTAATAAT
TGCCCCTGTTCGGATGCCG -> GCCCCTGTTCGGATGCCGT
TGCCCTCGGACGTAATAAT -> GCCCTCGGACGTAATAATC
TGCCGTAAGTAGCTAGCAA -> GCCGTAAGTAGCTAGCAAT
TGCCGTTAAGATATCACAT -> GCCGTTAAGATATCACATT
TGCGAACCCTATTTCACCA -> GCGAACCCTATTTCACCAG
TGCGATACTTTCATCTTCA -> GCGATACTTTCATCTTCAA
TGCGCACTTATGGACACGC -> GCGCACTTATGGACACGCG
TGCGCAGGGATCATGTATG -> GCGCAGGGATCATGTATGA
TGCGGAGCTGTGAGTGTGA -> GCGGAGCTGTGAGTGTGAA
TGCGGTATTCGAATTGGTC -> GCGGTATTCGAATTGGTCT
TGCGTAGATAGCATTGCTT -> GCGTAGATAGCATTGCTTG
TGCTACGATTTCTTTGTGA -> GCTACGATTTCTTTGTGAT
TGCTAGGTCAGGTGAACGC -> GCTAGGTCAGGTGAACGCA
TGCTTACGTCTGGACGTCT -> GCTTACGTCTGGACGTCTA
TGCTTGAACGTGCGGTATT -> GCTTGAACGTGCGGTATTC
TGCTTGCGAACCCTATTTC -> GCTTGCGAACCCTATTTCA
TGGAAAACACGAACGAGCA -> GGAAAACACGAACGAGCAA
TGGACACGCGGTGAATGTG -> GGACACGCGGTGAATGTGG
TGGACCGGCCGAATGTACG -> GGACCGGCCGAATGTACGA
TGGACCTATTTTAGGCGGA -> GGACCTATTTTAGGCGGAA
TGGACGATATGAACAGTCA -> GGACGATATGAACAGTCAA
TGGACGTCTAACGACCTGA -> GGACGTCTAACGACCTGAG
TGGAGAAGAATTTCTCTTT -> GGAGAAGAATTTCTCTTTT
TGGAGACAAACGTACCACA -> GGAGACAAACGTACCACAG
TGGAGATATGGCACCAACA -> GGAGATATGGCACCAACAG
TGGAGGGGTTAATCTTCCC -> GGAGGGGTTAATCTTCCCA
TGGAGTGCCAATATCTACG -> GGAGTGCCAATATCTACGT
TGGATGCAGTAGCAACACA -> GGATGCAGTAGCAACACAC
TGGCAAGCAACCCAGGGGC -> GGCAAGCAACCCAGGGGCC
TGGCACCAACAGAGGTGGG -> GGCACCAACAGAGGTGGGT
TGGCAGGTACACCTGATCA -> GGCAGGTACACCTGATCAC
TGGCATGAACACCGGACAA -> GGCATGAACACCGGACAAG
TGGCCGGGCACACCCGTTT -> GGCCGGGCACACCCGTTTG
TGGCGAGGGTCGTGCCAAA -> GGCGAGGGTCGTGCCAAAG
TGGCGGCAATAAGCGGACT -> GGCGGCAATAAGCGGACTT
TGGCTGCACGCTATAATAG -> GGCTGCACGCTATAATAGA
TGGCTTATTTACAATAAGA -> GGCTTATTTACAATAAGAC
TGGGACACAGTGGGTACAA -> GGGACACAGTGGGTACAAC
TGGGCAGATTTGCGCAGGG -> GGGCAGATTTGCGCAGGGA
TGGGCGAGTTAGTCGGTTG -> GGGCGAGTTAGTCGGTTGA
TGGGTAAGGTCCTATTCGA -> GGGTAAGGTCCTATTCGAT
TGGGTACAACAGACAGGCT -> GGGTACAACAGACAGGCTG
TGGGTATACTGATACTGCA -> GGGTATACTGATACTGCAC
TGGGTTCGTTCAAGCGATG -> GGGTTCGTTCAAGCGATGT
TGGTATATCTCACGTAATA -> GGTATATCTCACGTAATAA
TGGTCAGGACGGGCAGTCC -> GGTCAGGACGGGCAGTCCG
TGGTCTCAAGGCCCGCGTC -> GGTCTCAAGGCCCGCGTCT
TGTAAGTAGCTAGCAATCT -> GTAAGTAGCTAGCAATCTT
TGTAATGGAGACAAACGTA -> GTAATGGAGACAAACGTAC
TGTACAAACTTAAGGACTT -> GTACAAACTTAAGGACTTC
TGTACGACGCGATAGCACC -> GTACGACGCGATAGCACCC
TGTAGAGCGGTGACGCCAT -> GTAGAGCGGTGACGCCATT
TGTATCCGACTTTACCCAT -> GTATCCGACTTTACCCATA
TGTATGACCCCACCCCTAA -> GTATGACCCCACCCCTAAC
TGTATGTAAGTAGCTAGCA -> GTATGTAAGTAGCTAGCAA
TGTCAAACTGGGTAAGGTC -> GTCAAACTGGGTAAGGTCC
TGTCACCGGACAGCGGCAA -> GTCACCGGACAGCGGCAAG
TGTCACGTGCTTACGTCTG -> GTCACGTGCTTACGTCTGG
TGTCAGACCCGGGAGCTCC -> GTCAGACCCGGGAGCTCCA
TGTCATGCGCACTTATGGA -> GTCATGCGCACTTATGGAC
TGTCCCACGCCACGACATT -> GTCCCACGCCACGACATTT
TGTCCCTCTTTCATCGGTA -> GTCCCTCTTTCATCGGTAA
TGTCCTATACGCAAGTAAC -> GTCCTATACGCAAGTAACG
TGTCGCGAAGTTCTAGCCC -> GTCGCGAAGTTCTAGCCCT
TGTCTGAACCGTGGACCGG -> GTCTGAACCGTGGACCGGC
TGTCTTTTGCAGCGCGCGG -> GTCTTTTGCAGCGCGCGGT
TGTGAAGCAGCCGATTCTG -> GTGAAGCAGCCGATTCTGT
TGTGACAACGTGCTAGGTC -> GTGACAACGTGCTAGGTCA
TGTGACTTTTTGTCCCACG -> GTGACTTTTTGTCCCACGC
TGTGAGTGTGAAGCAGCCG -> GTGAGTGTGAAGCAGCCGA
TGTGATCTAAACTAGTGTC -> GTGATCTAAACTAGTGTCG
TGTGCATCGTTCTGTGTCC -> GTGCATCGTTCTGTGTCCC
TGTGCGATACTTTCATCTT -> GTGCGATACTTTCATCTTC
TGTGCTACGATTTCTTTGT -> GTGCTACGATTTCTTTGTG
TGTGGAGATATGGCACCAA -> GTGGAGATATGGCACCAAC
TGTGGAGGGGTTAATCTTC -> GTGGAGGGGTTAATCTTCC
TGTGGCGGCAATAAGCGGA -> GTGGCGGCAATAAGCGGAC
TGTGGGCGAGTTAGTCGGT -> GTGGGCGAGTTAGTCGGTT
TGTGTCCCTCTTTCATCGG -> GTGTCCCTCTTTCATCGGT
TGTGTCTTTTGCAGCGCGC -> GTGTCTTTTGCAGCGCGCG
TGTTAAGTACAGTCGCCCC -> GTTAAGTACAGTCGCCCCG
TGTTCCCTAGGATCCCTTT -> GTTCCCTAGGATCCCTTTC
TGTTCGGATGCCGTTAAGA -> GTTCGGATGCCGTTAAGAT
TGTTCTGCATGAGGACCGT -> GTTCTGCATGAGGACCGTA
TGTTGACGCACGAGAGAAC -> GTTGACGCACGAGAGAACG
TGTTGCCCTCGGACGTAAT -> GTTGCCCTCGGACGTAATA
TGTTTCCACTTAACGAACG -> GTTTCCACTTAACGAACGC
TTAACGAACGCACAGCAGG -> TAACGAACGCACAGCAGGA
TTAAGATATCACATTGTGG -> TAAGATATCACATTGTGGG
TTAAGGACTTCAGGAGGAT -> TAAGGACTTCAGGAGGATC
TTAAGGGAGTCGCCACATT -> TAAGGGAGTCGCCACATTC
TTAAGTACAGTCGCCCCGT -> TAAGTACAGTCGCCCCGTT
TTAATACGTCAACAGGTAT -> TAATACGTCAACAGGTATC
TTAATATCGGCATTTGAAC -> TAATATCGGCATTTGAACA
TTAATCAGCAGAAACGCCA -> TAATCAGCAGAAACGCCAT
TTAATCTTCCCATCAAAGA -> TAATCTTCCCATCAAAGAT
TTAATGCCCCTGTTCGGAT -> TAATGCCCCTGTTCGGATG
TTAATTTAATATCGGCATT -> TAATTTAATATCGGCATTT
TTACAAGGGTGATTACATA -> TACAAGGGTGATTACATAG
TTACAATAAGACAGACATG -> TACAATAAGACAGACATGA
TTACATAGCGCGAAAGCTA -> TACATAGCGCGAAAGCTAG
TTACCCATACAGCAGCAAA -> TACCCATACAGCAGCAAAC
TTACGAGTCTTAAGGGAGT -> TACGAGTCTTAAGGGAGTC
TTACGTCTGGACGTCTAAC -> TACGTCTGGACGTCTAACG
TTACTCGTCGTTGTGGAGG -> TACTCGTCGTTGTGGAGGG
TTAGGCGGAAAGCTGCGTA -> TAGGCGGAAAGCTGCGTAG
TTAGTCGGTTGAACCCGCC -> TAGTCGGTTGAACCCGCCA
TTAGTCTGAGGGATCTCTA -> TAGTCTGAGGGATCTCTAG
TTATCTCCGTGTTCTGCAT -> TATCTCCGTGTTCTGCATG
TTATGGACACGCGGTGAAT -> TATGGACACGCGGTGAATG
TTATTTACAATAAGACAGA -> TATTTACAATAAGACAGAC
TTCAAATACGAACCCAGCT -> TCAAATACGAACCCAGCTG
TTCAAGCGATGTACAAACT -> TCAAGCGATGTACAAACTT
TTCAATCATTACAAGGGTG -> TCAATCATTACAAGGGTGA
TTCACCAGGGCGGCAATTA -> TCACCAGGGCGGCAATTAA
TTCAGGAGGATCGCTGCCA -> TCAGGAGGATCGCTGCCAG
TTCAGTTGGGCAGATTTGC -> TCAGTTGGGCAGATTTGCG
TTCATCGGTAAGTAGCTAG -> TCATCGGTAAGTAGCTAGC
TTCATCTTCAATCATTACA -> TCATCTTCAATCATTACAA
TTCATTGTCAAACTGGGTA -> TCATTGTCAAACTGGGTAA
TTCCACTTAACGAACGCAC -> TCCACTTAACGAACGCACA
TTCCCATCAAAGATTCTAC -> TCCCATCAAAGATTCTACA
TTCCCTAGGATCCCTTTCT -> TCCCTAGGATCCCTTTCTT
TTCCGTCAGAACTTTGGAC -> TCCGTCAGAACTTTGGACG
TTCCTCGTTAGTCTGAGGG -> TCCTCGTTAGTCTGAGGGA
TTCGAATTGGTCTCAAGGC -> TCGAATTGGTCTCAAGGCC
TTCGATTTGAAGGTTGGTC -> TCGATTTGAAGGTTGGTCA
TTCGCAGGAGGTATCTGTC -> TCGCAGGAGGTATCTGTCT
TTCGGATGCCGTTAAGATA -> TCGGATGCCGTTAAGATAT
TTCGGCGGGGCCGCGCATC -> TCGGCGGGGCCGCGCATCG
TTCGTTCAAGCGATGTACA -> TCGTTCAAGCGATGTACAA
TTCTAAGCCTTGGCAGGTA -> TCTAAGCCTTGGCAGGTAC
TTCTACAAGTTGAGGGGCT -> TCTACAAGTTGAGGGGCTA
TTCTAGCCCTCAGCGCATC -> TCTAGCCCTCAGCGCATCC
TTCTCGCGGGTGAGGTAGA -> TCTCGCGGGTGAGGTAGAC
TTCTCTTTTTCTGTGCTAC -> TCTCTTTTTCTGTGCTACG
TTCTGCATGAGGACCGTAT -> TCTGCATGAGGACCGTATG
TTCTGTGCATCGTTCTGTG -> TCTGTGCATCGTTCTGTGT
TTCTGTGCTACGATTTCTT -> TCTGTGCTACGATTTCTTT
TTCTGTGTCCCTCTTTCAT -> TCTGTGTCCCTCTTTCATC
TTCTTCCTCGTTAGTCTGA -> TCTTCCTCGTTAGTCTGAG
TTCTTGCAGTATTCTAAGC -> TCTTGCAGTATTCTAAGCC
TTCTTTGTGATCTAAACTA -> TCTTTGTGATCTAAACTAG
TTGAACATAAGAAGTCTTG -> TGAACATAAGAAGTCTTGC
TTGAACCCGCCATCTCAAG -> TGAACCCGCCATCTCAAGA
TTGAACGTGCGGTATTCGA -> TGAACGTGCGGTATTCGAA
TTGAAGGTTGGTCAGGACG -> TGAAGGTTGGTCAGGACGG
TTGACCACGCTTTCTCGCG -> TGACCACGCTTTCTCGCGG
TTGACGCACGAGAGAACGA -> TGACGCACGAGAGAACGAC
TTGAGGGGCTACTACTAAT -> TGAGGGGCTACTACTAATG
TTGCACTGTGACAACGTGC -> TGCACTGTGACAACGTGCT
TTGCAGCGCGCGGTCAGCG -> TGCAGCGCGCGGTCAGCGA
TTGCAGTATTCTAAGCCTT -> TGCAGTATTCTAAGCCTTG
TTGCCAGGAGTAAGTAGCT -> TGCCAGGAGTAAGTAGCTA
TTGCCCTCGGACGTAATAA -> TGCCCTCGGACGTAATAAT
TTGCGAACCCTATTTCACC -> TGCGAACCCTATTTCACCA
TTGCGCAGGGATCATGTAT -> TGCGCAGGGATCATGTATG
TTGCGGAGCTGTGAGTGTG -> TGCGGAGCTGTGAGTGTGA
TTGCTTGAACGTGCGGTAT -> TGCTTGAACGTGCGGTATT
TTGCTTGCGAACCCTATTT -> TGCTTGCGAACCCTATTTC
TTGGAAAACACGAACGAGC -> TGGAAAACACGAACGAGCA
TTGGACGATATGAACAGTC -> TGGACGATATGAACAGTCA
TTGGCAGGTACACCTGATC -> TGGCAGGTACACCTGATCA
TTGGGCAGATTTGCGCAGG -> TGGGCAGATTTGCGCAGGG
TTGGTATATCTCACGTAAT -> TGGTATATCTCACGTAATA
TTGGTCAGGACGGGCAGTC -> TGGTCAGGACGGGCAGTCC
TTGGTCTCAAGGCCCGCGT -> TGGTCTCAAGGCCCGCGTC
TTGTCAAACTGGGTAAGGT -> TGTCAAACTGGGTAAGGTC
TTGTCATGCGCACTTATGG -> TGTCATGCGCACTTATGGA
TTGTCCCACGCCACGACAT -> TGTCCCACGCCACGACATT
TTGTGATCTAAACTAGTGT -> TGTGATCTAAACTAGTGTC
TTGTGGAGGGGTTAATCTT -> TGTGGAGGGGTTAATCTTC
TTGTGGCGGCAATAAGCGG -> TGTGGCGGCAATAAGCGGA
TTGTGGGCGAGTTAGTCGG -> TGTGGGCGAGTTAGTCGGT
TTGTTAAGTACAGTCGCCC -> TGTTAAGTACAGTCGCCCC
TTGTTTCCACTTAACGAAC -> TGTTTCCACTTAACGAACG
TTTAATATCGGCATTTGAA -> TTAATATCGGCATTTGAAC
TTTAATGCCCCTGTTCGGA -> TTAATGCCCCTGTTCGGAT
TTTACAATAAGACAGACAT -> TTACAATAAGACAGACATG
TTTACCCATACAGCAGCAA -> TTACCCATACAGCAGCAAA
TTTACGAGTCTTAAGGGAG -> TTACGAGTCTTAAGGGAGT
TTTAGGCGGAAAGCTGCGT -> TTAGGCGGAAAGCTGCGTA
TTTCACCAGGGCGGCAATT -> TTCACCAGGGCGGCAATTA
TTTCATCGGTAAGTAGCTA -> TTCATCGGTAAGTAGCTAG
TTTCATCTTCAATCATTAC -> TTCATCTTCAATCATTACA
TTTCCACTTAACGAACGCA -> TTCCACTTAACGAACGCAC
TTTCGCAGGAGGTATCTGT -> TTCGCAGGAGGTATCTGTC
TTTCGGCGGGGCCGCGCAT -> TTCGGCGGGGCCGCGCATC
TTTCTCGCGGGTGAGGTAG -> TTCTCGCGGGTGAGGTAGA
TTTCTCTTTTTCTGTGCTA -> TTCTCTTTTTCTGTGCTAC
TTTCTGTGCTACGATTTCT -> TTCTGTGCTACGATTTCTT
TTTCTTGCAGTATTCTAAG -> TTCTTGCAGTATTCTAAGC
TTTCTTTGTGATCTAAACT -> TTCTTTGTGATCTAAACTA
TTTGAACATAAGAAGTCTT -> TTGAACATAAGAAGTCTTG
TTTGAAGGTTGGTCAGGAC -> TTGAAGGTTGGTCAGGACG
TTTGACCACGCTTTCTCGC -> TTGACCACGCTTTCTCGCG
TTTGCACTGTGACAACGTG -> TTGCACTGTGACAACGTGC
TTTGCAGCGCGCGGTCAGC -> TTGCAGCGCGCGGTCAGCG
TTTGCGCAGGGATCATGTA -> TTGCGCAGGGATCATGTAT
TTTGGACGATATGAACAGT -> TTGGACGATATGAACAGTC
TTTGTCCCACGCCACGACA -> TTGTCCCACGCCACGACAT
TTTGTGATCTAAACTAGTG -> TTGTGATCTAAACTAGTGT
TTTTAATGCCCCTGTTCGG -> TTTAATGCCCCTGTTCGGA
TTTTAGGCGGAAAGCTGCG -> TTTAGGCGGAAAGCTGCGT
TTTTCTGTGCTACGATTTC -> TTTCTGTGCTACGATTTCT
TTTTGCAGCGCGCGGTCAG -> TTTGCAGCGCGCGGTCAGC
TTTTGTCCCACGCCACGAC -> TTTGTCCCACGCCACGACA
TTTTTCTGTGCTACGATTT -> TTTTCTGTGCTACGATTTC
TTTTTGTCCCACGCCACGA -> TTTTGTCCCACGCCACGAC
